a	a
à	à
ả	ả
ã	ã
á	á
ạ	ạ
ắ	ắ
ác	ác
ạc	ạc
ặc	ặc
ắc	ắc
ách	ách
ạch	ạch
ai	ai
ải	ải
ái	ái
am	am
ảm	ảm
ám	ám
ậm	ậm
ẵm	ẵm
ầm	ầm
ẩm	ẩm
ấm	ấm
an	an
án	án
ần	ần
ẩn	ẩn
ấn	ấn
ang	ang
ảng	ảng
ãng	ãng
áng	áng
ẳng	ẳng
ắng	ắng
anh	anh
ảnh	ảnh
ánh	ánh
ao	ao
ào	ào
ảo	ảo
áo	áo
áp	áp
ập	ập
ắp	ắp
ấp	ấp
át	át
ạt	ạt
ắt	ắt
ất	ất
au	au
àu	àu
áu	áu
ầu	ầu
ẩu	ẩu
ấu	ấu
ay	ay
áy	áy
ậy	ậy
ầy	ầy
ấy	ấy
ăm	ăm
ăn	ăn
ăng	ăng
âm	âm
ân	ân
âng	âng
âu	âu
ây	ây
ba	b a
bà	b à
bả	b ả
bã	b ã
bá	b á
bạ	b ạ
bác	b ác
bạc	b ạc
bặc	b ặc
bậc	b ậc
bắc	b ắc
bấc	b ấc
bách	b ách
bạch	b ạch
bai	b ai
bài	b ài
bải	b ải
bãi	b ãi
bái	b ái
bại	b ại
bam	b am
bảm	b ảm
bám	b ám
bặm	b ặm
bậm	b ậm
bằm	b ằm
bẵm	b ẵm
bầm	b ầm
bẩm	b ẩm
bẫm	b ẫm
bấm	b ấm
ban	b an
bàn	b àn
bản	b ản
bán	b án
bạn	b ạn
bận	b ận
bẳn	b ẳn
bắn	b ắn
bần	b ần
bẩn	b ẩn
bấn	b ấn
bang	b ang
bàng	b àng
bảng	b ảng
báng	b áng
bạng	b ạng
bằng	b ằng
bẳng	b ẳng
bẵng	b ẵng
bắng	b ắng
bẫng	b ẫng
banh	b anh
bành	b ành
bảnh	b ảnh
bánh	b ánh
bạnh	b ạnh
bao	b ao
bào	b ào
bảo	b ảo
bão	b ão
báo	b áo
bạo	b ạo
báp	b áp
bặp	b ặp
bập	b ập
bắp	b ắp
bấp	b ấp
bát	b át
bạt	b ạt
bặt	b ặt
bật	b ật
bắt	b ắt
bất	b ất
bau	b au
bàu	b àu
bảu	b ảu
báu	b áu
bậu	b ậu
bầu	b ầu
bẩu	b ẩu
bấu	b ấu
bay	b ay
bày	b ày
bảy	b ảy
báy	b áy
bậy	b ậy
bầy	b ầy
bẩy	b ẩy
bẫy	b ẫy
bấy	b ấy
băm	b ăm
băn	b ăn
băng	b ăng
bâm	b âm
bân	b ân
bâng	b âng
bâu	b âu
bây	b ây
be	b e
bè	b è
bẻ	b ẻ
bẽ	b ẽ
bé	b é
bẹ	b ẹ
bệ	b ệ
bề	b ề
bể	b ể
bễ	b ễ
bế	b ế
béc	b éc
bẹc	b ẹc
bệch	b ệch
bếch	b ếch
bem	b em
bèm	b èm
bẻm	b ẻm
ben	b en
bèn	b èn
bẽn	b ẽn
bén	b én
bẹn	b ẹn
bện	b ện
bền	b ền
bển	b ển
bến	b ến
beng	b eng
béng	b éng
bệnh	b ệnh
bềnh	b ềnh
beo	b eo
bèo	b èo
bẽo	b ẽo
béo	b éo
bép	b ép
bẹp	b ẹp
bếp	b ếp
bét	b ét
bẹt	b ẹt
bệt	b ệt
bết	b ết
bê	b ê
bêm	b êm
bên	b ên
bênh	b ênh
bêu	b êu
bi	b i
bì	b ì
bỉ	b ỉ
bĩ	b ĩ
bí	b í
bị	b ị
bia	b ia
bìa	b ìa
bía	b ía
bịa	b ịa
bích	b ích
bịch	b ịch
biếc	b iếc
biếm	b iếm
biện	b iện
biền	b iền
biển	b iển
biến	b iến
biếng	b iếng
biệt	b iệt
biết	b iết
biều	b iều
biểu	b iểu
biếu	b iếu
biên	b iên
biêng	b iêng
biêu	b iêu
bim	b im
bìm	b ìm
bỉm	b ỉm
bím	b ím
bin	b in
bịn	b ịn
binh	b inh
bình	b ình
bỉnh	b ỉnh
bĩnh	b ĩnh
bính	b ính
bịnh	b ịnh
bíp	b íp
bịp	b ịp
bít	b ít
bịt	b ịt
biu	b iu
bìu	b ìu
bỉu	b ỉu
bĩu	b ĩu
bịu	b ịu
bo	b o
bò	b ò
bỏ	b ỏ
bõ	b õ
bó	b ó
bọ	b ọ
bộ	b ộ
bồ	b ồ
bổ	b ổ
bỗ	b ỗ
bố	b ố
bờ	b ờ
bở	b ở
bỡ	b ỡ
bớ	b ớ
bợ	b ợ
boa	b oa
boai	b oai
boát	b oát
bóc	b óc
bọc	b ọc
bộc	b ộc
bốc	b ốc
boi	b oi
bòi	b òi
bỏi	b ỏi
bói	b ói
bội	b ội
bồi	b ồi
bổi	b ổi
bối	b ối
bời	b ời
bởi	b ởi
bới	b ới
bom	b om
bỏm	b ỏm
bõm	b õm
bờm	b ờm
bợm	b ợm
bon	b on
bòn	b òn
bỏn	b ỏn
bón	b ón
bọn	b ọn
bộn	b ộn
bồn	b ồn
bổn	b ổn
bốn	b ốn
bờn	b ờn
bỡn	b ỡn
bong	b ong
bòng	b òng
bỏng	b ỏng
bõng	b õng
bóng	b óng
bọng	b ọng
bồng	b ồng
bổng	b ổng
bỗng	b ỗng
bống	b ống
boóc	b oóc
boọc	b oọc
boong	b oong
boóng	b oóng
bóp	b óp
bọp	b ọp
bộp	b ộp
bốp	b ốp
bớp	b ớp
bợp	b ợp
bót	b ót
bọt	b ọt
bột	b ột
bốt	b ốt
bớt	b ớt
bợt	b ợt
bô	b ô
bôi	b ôi
bôm	b ôm
bôn	b ôn
bông	b ông
bơ	b ơ
bơi	b ơi
bơm	b ơm
bơn	b ơn
bu	b u
bù	b ù
bú	b ú
bụ	b ụ
bự	b ự
bua	b ua
bùa	b ùa
bủa	b ủa
búa	b úa
bụa	b ụa
bừa	b ừa
bửa	b ửa
bữa	b ữa
bựa	b ựa
búc	b úc
bục	b ục
bức	b ức
bực	b ực
bui	b ui
bùi	b ùi
búi	b úi
bụi	b ụi
bum	b um
bùm	b ùm
bủm	b ủm
bụm	b ụm
bừm	b ừm
bứm	b ứm
bun	b un
bùn	b ùn
bủn	b ủn
bún	b ún
bừn	b ừn
bung	b ung
bùng	b ùng
bủng	b ủng
búng	b úng
bụng	b ụng
bừng	b ừng
bứng	b ứng
buộc	b uộc
buốc	b uốc
buồi	b uồi
buổi	b uổi
buồm	b uồm
buồn	b uồn
buồng	b uồng
buột	b uột
buốt	b uốt
buôn	b uôn
buông	b uông
búp	b úp
bụp	b ụp
bút	b út
bụt	b ụt
bứt	b ứt
bửu	b ửu
buy	b uy
buýt	b uýt
bư	b ư
bưi	b ưi
bưm	b ưm
bưn	b ưn
bưng	b ưng
bước	b ước
bưởi	b ưởi
bướm	b ướm
bường	b ường
bướng	b ướng
bướu	b ướu
bươi	b ươi
bươm	b ươm
bươn	b ươn
bương	b ương
bươu	b ươu
bưu	b ưu
ca	c a
cà	c à
cả	c ả
cá	c á
cạ	c ạ
các	c ác
cạc	c ạc
cặc	c ặc
cắc	c ắc
cấc	c ấc
cách	c ách
cạch	c ạch
cai	c ai
cài	c ài
cải	c ải
cãi	c ãi
cái	c ái
cam	c am
càm	c àm
cảm	c ảm
cám	c ám
cạm	c ạm
cặm	c ặm
cằm	c ằm
cắm	c ắm
cầm	c ầm
cẩm	c ẩm
cấm	c ấm
can	c an
càn	c àn
cản	c ản
cán	c án
cạn	c ạn
cặn	c ặn
cận	c ận
cằn	c ằn
cắn	c ắn
cần	c ần
cẩn	c ẩn
cấn	c ấn
cang	c ang
càng	c àng
cảng	c ảng
cáng	c áng
cặng	c ặng
cậng	c ậng
cẳng	c ẳng
cẩng	c ẩng
cẫng	c ẫng
canh	c anh
cành	c ành
cảnh	c ảnh
cánh	c ánh
cạnh	c ạnh
cao	c ao
cào	c ào
cảo	c ảo
cáo	c áo
cạo	c ạo
cáp	c áp
cạp	c ạp
cặp	c ặp
cập	c ập
cắp	c ắp
cấp	c ấp
cát	c át
cặt	c ặt
cật	c ật
cắt	c ắt
cất	c ất
cau	c au
càu	c àu
cảu	c ảu
cáu	c áu
cậu	c ậu
cầu	c ầu
cẩu	c ẩu
cấu	c ấu
cay	c ay
cày	c ày
cáy	c áy
cạy	c ạy
cậy	c ậy
cầy	c ầy
cấy	c ấy
căm	c ăm
căn	c ăn
căng	c ăng
câm	c âm
cân	c ân
câng	c âng
câu	c âu
cây	c ây
cha	ch a
chà	ch à
chả	ch ả
chã	ch ã
chá	ch á
chạ	ch ạ
chác	ch ác
chạc	ch ạc
chặc	ch ặc
chậc	ch ậc
chắc	ch ắc
chạch	ch ạch
chai	ch ai
chài	ch ài
chải	ch ải
chãi	ch ãi
chái	ch ái
chàm	ch àm
chạm	ch ạm
chặm	ch ặm
chậm	ch ậm
chằm	ch ằm
chầm	ch ầm
chẩm	ch ẩm
chẫm	ch ẫm
chấm	ch ấm
chan	ch an
chàn	ch àn
chán	ch án
chạn	ch ạn
chặn	ch ặn
chận	ch ận
chằn	ch ằn
chẵn	ch ẵn
chắn	ch ắn
chần	ch ần
chẩn	ch ẩn
chấn	ch ấn
chang	ch ang
chàng	ch àng
chảng	ch ảng
cháng	ch áng
chạng	ch ạng
chặng	ch ặng
chằng	ch ằng
chẳng	ch ẳng
chanh	ch anh
chành	ch ành
chảnh	ch ảnh
chánh	ch ánh
chạnh	ch ạnh
chao	ch ao
chào	ch ào
chảo	ch ảo
cháo	ch áo
chạo	ch ạo
cháp	ch áp
chạp	ch ạp
chặp	ch ặp
chập	ch ập
chắp	ch ắp
chấp	ch ấp
chát	ch át
chặt	ch ặt
chật	ch ật
chắt	ch ắt
chất	ch ất
chau	ch au
cháu	ch áu
chậu	ch ậu
chầu	ch ầu
chẩu	ch ẩu
chấu	ch ấu
chay	ch ay
chày	ch ày
chảy	ch ảy
cháy	ch áy
chạy	ch ạy
chầy	ch ầy
chấy	ch ấy
chăm	ch ăm
chăn	ch ăn
chăng	ch ăng
châm	ch âm
chân	ch ân
châu	ch âu
chây	ch ây
che	ch e
chè	ch è
chẻ	ch ẻ
chẽ	ch ẽ
ché	ch é
chệ	ch ệ
chề	ch ề
chế	ch ế
chéc	ch éc
chệch	ch ệch
chếch	ch ếch
chem	ch em
chèm	ch èm
chém	ch ém
chễm	ch ễm
chen	ch en
chèn	ch èn
chén	ch én
chẹn	ch ẹn
cheng	ch eng
chệnh	ch ệnh
chềnh	ch ềnh
chểnh	ch ểnh
chếnh	ch ếnh
cheo	ch eo
chèo	ch èo
chẻo	ch ẻo
chéo	ch éo
chép	ch ép
chẹp	ch ẹp
chét	ch ét
chẹt	ch ẹt
chết	ch ết
chê	ch ê
chêm	ch êm
chênh	ch ênh
chi	ch i
chì	ch ì
chỉ	ch ỉ
chí	ch í
chị	ch ị
chia	ch ia
chìa	ch ìa
chỉa	ch ỉa
chĩa	ch ĩa
chía	ch ía
chích	ch ích
chịch	ch ịch
chiếc	ch iếc
chiếm	ch iếm
chiện	ch iện
chiền	ch iền
chiển	ch iển
chiến	ch iến
chiềng	ch iềng
chiếng	ch iếng
chiệp	ch iệp
chiếp	ch iếp
chiết	ch iết
chiều	ch iều
chiểu	ch iểu
chiếu	ch iếu
chiêm	ch iêm
chiên	ch iên
chiêng	ch iêng
chiêu	ch iêu
chim	ch im
chìm	ch ìm
chím	ch ím
chin	ch in
chỉn	ch ỉn
chín	ch ín
chinh	ch inh
chình	ch ình
chỉnh	ch ỉnh
chĩnh	ch ĩnh
chính	ch ính
chíp	ch íp
chít	ch ít
chịt	ch ịt
chiu	ch iu
chìu	ch ìu
chíu	ch íu
chịu	ch ịu
cho	ch o
chò	ch ò
chỏ	ch ỏ
chõ	ch õ
chó	ch ó
chọ	ch ọ
chộ	ch ộ
chồ	ch ồ
chổ	ch ổ
chỗ	ch ỗ
chờ	ch ờ
chở	ch ở
chớ	ch ớ
chợ	ch ợ
choa	ch oa
chóa	ch óa
choác	ch oác
choạc	ch oạc
choai	ch oai
choàm	ch oàm
choán	ch oán
choang	ch oang
choàng	ch oàng
choảng	ch oảng
choáng	ch oáng
choạng	ch oạng
choạp	ch oạp
choắt	ch oắt
chóc	ch óc
chọc	ch ọc
chốc	ch ốc
choe	ch oe
choé	ch oé
choẹ	ch oẹ
chòe	ch òe
chóe	ch óe
chọe	ch ọe
choèn	ch oèn
choét	ch oét
choẹt	ch oẹt
choi	ch oi
chòi	ch òi
chói	ch ói
chọi	ch ọi
chội	ch ội
chồi	ch ồi
chổi	ch ổi
chối	ch ối
chời	ch ời
chới	ch ới
chom	ch om
chòm	ch òm
chỏm	ch ỏm
chõm	ch õm
chồm	ch ồm
chờm	ch ờm
chởm	ch ởm
chớm	ch ớm
chon	ch on
chọn	ch ọn
chộn	ch ộn
chồn	ch ồn
chốn	ch ốn
chờn	ch ờn
chong	ch ong
chòng	ch òng
chỏng	ch ỏng
chõng	ch õng
chóng	ch óng
chồng	ch ồng
chổng	ch ổng
chống	ch ống
choóc	ch oóc
choọc	ch oọc
chóp	ch óp
chộp	ch ộp
chớp	ch ớp
chợp	ch ợp
chót	ch ót
chọt	ch ọt
chột	ch ột
chốt	ch ốt
chớt	ch ớt
chợt	ch ợt
chô	ch ô
chôi	ch ôi
chôm	ch ôm
chôn	ch ôn
chông	ch ông
chơ	ch ơ
chơi	ch ơi
chơm	ch ơm
chơn	ch ơn
chu	ch u
chù	ch ù
chủ	ch ủ
chũ	ch ũ
chú	ch ú
chừ	ch ừ
chử	ch ử
chữ	ch ữ
chứ	ch ứ
chua	ch ua
chùa	ch ùa
chúa	ch úa
chừa	ch ừa
chửa	ch ửa
chữa	ch ữa
chứa	ch ứa
chuẩn	ch uẩn
chúc	ch úc
chục	ch ục
chức	ch ức
chực	ch ực
chui	ch ui
chùi	ch ùi
chũi	ch ũi
chúi	ch úi
chửi	ch ửi
chum	ch um
chùm	ch ùm
chũm	ch ũm
chúm	ch úm
chụm	ch ụm
chừm	ch ừm
chun	ch un
chùn	ch ùn
chũn	ch ũn
chún	ch ún
chung	ch ung
chùng	ch ùng
chủng	ch ủng
chúng	ch úng
chừng	ch ừng
chửng	ch ửng
chững	ch ững
chứng	ch ứng
chựng	ch ựng
chuộc	ch uộc
chuốc	ch uốc
chuồi	ch uồi
chuỗi	ch uỗi
chuối	ch uối
chuồn	ch uồn
chuộng	ch uộng
chuồng	ch uồng
chuột	ch uột
chuốt	ch uốt
chuôi	ch uôi
chuôm	ch uôm
chuôn	ch uôn
chuông	ch uông
chụp	ch ụp
chút	ch út
chụt	ch ụt
chứt	ch ứt
chùy	ch ùy
chuyện	ch uyện
chuyền	ch uyền
chuyển	ch uyển
chuyến	ch uyến
chuyên	ch uyên
chư	ch ư
chưa	ch ưa
chưi	ch ưi
chưm	ch ưm
chưng	ch ưng
chước	ch ước
chười	ch ười
chưởi	ch ưởi
chườm	ch ườm
chường	ch ường
chưởng	ch ưởng
chướng	ch ướng
chươi	ch ươi
chương	ch ương
co	c o
cò	c ò
cỏ	c ỏ
có	c ó
cọ	c ọ
cộ	c ộ
cồ	c ồ
cổ	c ổ
cỗ	c ỗ
cố	c ố
cờ	c ờ
cở	c ở
cỡ	c ỡ
cớ	c ớ
cóc	c óc
cọc	c ọc
cộc	c ộc
cốc	c ốc
coi	c oi
còi	c òi
cỏi	c ỏi
cõi	c õi
cói	c ói
cọi	c ọi
cội	c ội
cỗi	c ỗi
cối	c ối
cời	c ời
cởi	c ởi
cỡi	c ỡi
com	c om
còm	c òm
cộm	c ộm
cồm	c ồm
cốm	c ốm
cỡm	c ỡm
con	c on
còn	c òn
cỏn	c ỏn
cón	c ón
cọn	c ọn
cồn	c ồn
cổn	c ổn
cờn	c ờn
cỡn	c ỡn
cợn	c ợn
cong	c ong
còng	c òng
cõng	c õng
cóng	c óng
cọng	c ọng
cộng	c ộng
cồng	c ồng
cổng	c ổng
cống	c ống
coóc	c oóc
coọc	c oọc
coong	c oong
coóng	c oóng
cóp	c óp
cọp	c ọp
cộp	c ộp
cốp	c ốp
cót	c ót
cọt	c ọt
cột	c ột
cốt	c ốt
cợt	c ợt
cô	c ô
côi	c ôi
côm	c ôm
côn	c ôn
công	c ông
cơ	c ơ
cơi	c ơi
cơm	c ơm
cơn	c ơn
cu	c u
cù	c ù
củ	c ủ
cũ	c ũ
cú	c ú
cụ	c ụ
cừ	c ừ
cử	c ử
cữ	c ữ
cứ	c ứ
cự	c ự
cua	c ua
cùa	c ùa
của	c ủa
cửa	c ửa
cứa	c ứa
cựa	c ựa
cúc	c úc
cục	c ục
cức	c ức
cực	c ực
cui	c ui
cùi	c ùi
củi	c ủi
cũi	c ũi
cúi	c úi
cụi	c ụi
cửi	c ửi
cùm	c ùm
cúm	c úm
cụm	c ụm
cừm	c ừm
cun	c un
cùn	c ùn
củn	c ủn
cũn	c ũn
cún	c ún
cừn	c ừn
cung	c ung
cùng	c ùng
củng	c ủng
cũng	c ũng
cúng	c úng
cụng	c ụng
cửng	c ửng
cứng	c ứng
cựng	c ựng
cuộc	c uộc
cuốc	c uốc
cuội	c uội
cuối	c uối
cuỗm	c uỗm
cuộn	c uộn
cuồn	c uồn
cuốn	c uốn
cuồng	c uồng
cuống	c uống
cuôi	c uôi
cuông	c uông
cúp	c úp
cụp	c ụp
cút	c út
cụt	c ụt
cứt	c ứt
cựt	c ựt
cừu	c ừu
cửu	c ửu
cữu	c ữu
cứu	c ứu
cựu	c ựu
cư	c ư
cưa	c ưa
cưi	c ưi
cưm	c ưm
cưn	c ưn
cưng	c ưng
cước	c ước
cược	c ược
cười	c ười
cưỡi	c ưỡi
cưới	c ưới
cườm	c ườm
cường	c ường
cưỡng	c ưỡng
cướp	c ướp
cươi	c ươi
cương	c ương
cưu	c ưu
da	d a
dà	d à
dả	d ả
dã	d ã
dá	d á
dạ	d ạ
dác	d ác
dạc	d ạc
dặc	d ặc
dắc	d ắc
dách	d ách
dai	d ai
dài	d ài
dải	d ải
dãi	d ãi
dái	d ái
dại	d ại
dám	d ám
dạm	d ạm
dặm	d ặm
dậm	d ậm
dằm	d ằm
dầm	d ầm
dẩm	d ẩm
dẫm	d ẫm
dấm	d ấm
dan	d an
dàn	d àn
dãn	d ãn
dán	d án
dạn	d ạn
dặn	d ặn
dận	d ận
dằn	d ằn
dần	d ần
dẩn	d ẩn
dẫn	d ẫn
dấn	d ấn
dang	d ang
dàng	d àng
dáng	d áng
dạng	d ạng
dằng	d ằng
dẳng	d ẳng
danh	d anh
dành	d ành
dánh	d ánh
dao	d ao
dào	d ào
dảo	d ảo
dáo	d áo
dạo	d ạo
dáp	d áp
dập	d ập
dấp	d ấp
dát	d át
dạt	d ạt
dặt	d ặt
dật	d ật
dắt	d ắt
dất	d ất
dậu	d ậu
dầu	d ầu
dẫu	d ẫu
dấu	d ấu
day	d ay
dày	d ày
dảy	d ảy
dãy	d ãy
dáy	d áy
dạy	d ạy
dậy	d ậy
dầy	d ầy
dẩy	d ẩy
dẫy	d ẫy
dấy	d ấy
dăm	d ăm
dăn	d ăn
dăng	d ăng
dâm	d âm
dân	d ân
dâng	d âng
dâu	d âu
dây	d ây
de	d e
dè	d è
dẻ	d ẻ
dẽ	d ẽ
dé	d é
dề	d ề
dể	d ể
dễ	d ễ
dế	d ế
déc	d éc
dẹc	d ẹc
dèm	d èm
den	d en
dền	d ền
dềnh	d ềnh
dẻo	d ẻo
dẹo	d ẹo
dép	d ép
dẹp	d ẹp
dét	d ét
dẹt	d ẹt
dệt	d ệt
dê	d ê
dên	d ên
di	d i
dì	d ì
dĩ	d ĩ
dí	d í
dị	d ị
dia	d ia
dìa	d ìa
dĩa	d ĩa
dích	d ích
dịch	d ịch
diệc	d iệc
diếc	d iếc
diệm	d iệm
diềm	d iềm
diễm	d iễm
diếm	d iếm
diện	d iện
diễn	d iễn
diến	d iến
diệp	d iệp
diếp	d iếp
diệt	d iệt
diết	d iết
diệu	d iệu
diều	d iều
diểu	d iểu
diễu	d iễu
diêm	d iêm
diên	d iên
diêng	d iêng
diêu	d iêu
dim	d im
dìm	d ìm
din	d in
dỉn	d ỉn
dĩn	d ĩn
dín	d ín
dinh	d inh
dình	d ình
dĩnh	d ĩnh
dính	d ính
díp	d íp
dịp	d ịp
dít	d ít
dịt	d ịt
diu	d iu
dìu	d ìu
díu	d íu
dịu	d ịu
do	d o
dò	d ò
dó	d ó
dọ	d ọ
dộ	d ộ
dồ	d ồ
dỗ	d ỗ
dờ	d ờ
dở	d ở
dỡ	d ỡ
dớ	d ớ
dợ	d ợ
dọa	d ọa
doan	d oan
doãn	d oãn
doanh	d oanh
dóc	d óc
dọc	d ọc
dộc	d ộc
dốc	d ốc
dòi	d òi
dõi	d õi
dói	d ói
dọi	d ọi
dội	d ội
dồi	d ồi
dổi	d ổi
dỗi	d ỗi
dối	d ối
dời	d ời
dới	d ới
dom	d om
dòm	d òm
dỏm	d ỏm
dởm	d ởm
dòn	d òn
dọn	d ọn
dồn	d ồn
dờn	d ờn
dỡn	d ỡn
dớn	d ớn
dong	d ong
dòng	d òng
dỏng	d ỏng
dõng	d õng
dóng	d óng
dộng	d ộng
dồng	d ồng
doọc	d oọc
dộp	d ộp
dớp	d ớp
dột	d ột
dốt	d ốt
dớt	d ớt
dợt	d ợt
dô	d ô
dôi	d ôi
dôn	d ôn
dông	d ông
dơ	d ơ
dơi	d ơi
dơn	d ơn
du	d u
dù	d ù
dũ	d ũ
dú	d ú
dụ	d ụ
dừ	d ừ
dử	d ử
dữ	d ữ
dứ	d ứ
dự	d ự
dua	d ua
dũa	d ũa
dúa	d úa
dụa	d ụa
dừa	d ừa
dứa	d ứa
dựa	d ựa
duẩn	d uẩn
duẫn	d uẫn
duật	d uật
duân	d uân
dúc	d úc
dục	d ục
dức	d ức
dực	d ực
duệ	d uệ
dui	d ui
dùi	d ùi
dũi	d ũi
dúi	d úi
dụi	d ụi
dùm	d ùm
dúm	d úm
dụm	d ụm
dừm	d ừm
dun	d un
dũn	d ũn
dún	d ún
dừn	d ừn
dung	d ung
dùng	d ùng
dũng	d ũng
dúng	d úng
dụng	d ụng
dừng	d ừng
dửng	d ửng
dứng	d ứng
dựng	d ựng
duỗi	d uỗi
duối	d uối
dụp	d ụp
dút	d út
dứt	d ứt
dựt	d ựt
duy	d uy
duyện	d uyện
duyến	d uyến
duyệt	d uyệt
duyên	d uyên
dư	d ư
dưa	d ưa
dưi	d ưi
dưn	d ưn
dưng	d ưng
dước	d ước
dược	d ược
dưới	d ưới
dường	d ường
dưỡng	d ưỡng
dượng	d ượng
dượt	d ượt
dươn	d ươn
dương	d ương
đa	đ a
đà	đ à
đả	đ ả
đã	đ ã
đá	đ á
đạ	đ ạ
đác	đ ác
đạc	đ ạc
đặc	đ ặc
đắc	đ ắc
đách	đ ách
đạch	đ ạch
đai	đ ai
đài	đ ài
đãi	đ ãi
đái	đ ái
đại	đ ại
đam	đ am
đàm	đ àm
đảm	đ ảm
đám	đ ám
đạm	đ ạm
đặm	đ ặm
đậm	đ ậm
đằm	đ ằm
đắm	đ ắm
đầm	đ ầm
đẫm	đ ẫm
đấm	đ ấm
đan	đ an
đàn	đ àn
đản	đ ản
đán	đ án
đạn	đ ạn
đặn	đ ặn
đận	đ ận
đẳn	đ ẳn
đắn	đ ắn
đần	đ ần
đẫn	đ ẫn
đang	đ ang
đàng	đ àng
đảng	đ ảng
đãng	đ ãng
đáng	đ áng
đặng	đ ặng
đằng	đ ằng
đẳng	đ ẳng
đẵng	đ ẵng
đắng	đ ắng
đấng	đ ấng
đanh	đ anh
đành	đ ành
đảnh	đ ảnh
đánh	đ ánh
đao	đ ao
đào	đ ào
đảo	đ ảo
đáo	đ áo
đạo	đ ạo
đáp	đ áp
đạp	đ ạp
đập	đ ập
đắp	đ ắp
đấp	đ ấp
đát	đ át
đạt	đ ạt
đặt	đ ặt
đật	đ ật
đắt	đ ắt
đất	đ ất
đau	đ au
đáu	đ áu
đậu	đ ậu
đầu	đ ầu
đẩu	đ ẩu
đấu	đ ấu
đay	đ ay
đày	đ ày
đáy	đ áy
đậy	đ ậy
đầy	đ ầy
đẩy	đ ẩy
đẫy	đ ẫy
đấy	đ ấy
đăm	đ ăm
đăn	đ ăn
đăng	đ ăng
đâm	đ âm
đân	đ ân
đâng	đ âng
đâu	đ âu
đây	đ ây
đe	đ e
đè	đ è
đẻ	đ ẻ
đẽ	đ ẽ
đệ	đ ệ
đề	đ ề
để	đ ể
đễ	đ ễ
đế	đ ế
đéc	đ éc
đệch	đ ệch
đếch	đ ếch
đem	đ em
đệm	đ ệm
đềm	đ ềm
đếm	đ ếm
đen	đ en
đèn	đ èn
đẻn	đ ẻn
đén	đ én
đền	đ ền
đến	đ ến
đeng	đ eng
đềnh	đ ềnh
đễnh	đ ễnh
đeo	đ eo
đèo	đ èo
đẽo	đ ẽo
đéo	đ éo
đép	đ ép
đẹp	đ ẹp
đếp	đ ếp
đét	đ ét
đẹt	đ ẹt
đệt	đ ệt
đết	đ ết
đều	đ ều
đểu	đ ểu
đếu	đ ếu
đê	đ ê
đêm	đ êm
đên	đ ên
đênh	đ ênh
đi	đ i
đì	đ ì
đỉ	đ ỉ
đĩ	đ ĩ
đìa	đ ìa
đỉa	đ ỉa
đĩa	đ ĩa
địa	đ ịa
đích	đ ích
địch	đ ịch
điếc	đ iếc
điềm	đ iềm
điểm	đ iểm
điếm	đ iếm
điện	đ iện
điền	đ iền
điển	đ iển
điếng	đ iếng
điệp	đ iệp
điệu	đ iệu
điều	đ iều
điểu	đ iểu
điếu	đ iếu
điên	đ iên
điêng	đ iêng
điêu	đ iêu
đim	đ im
đin	đ in
đinh	đ inh
đình	đ ình
đỉnh	đ ỉnh
đĩnh	đ ĩnh
đính	đ ính
định	đ ịnh
đíp	đ íp
địp	đ ịp
đít	đ ít
địt	đ ịt
điu	đ iu
đìu	đ ìu
địu	đ ịu
đo	đ o
đò	đ ò
đỏ	đ ỏ
đó	đ ó
đọ	đ ọ
độ	đ ộ
đồ	đ ồ
đổ	đ ổ
đỗ	đ ỗ
đố	đ ố
đờ	đ ờ
đỡ	đ ỡ
đợ	đ ợ
đóa	đ óa
đọa	đ ọa
đoạch	đ oạch
đoài	đ oài
đoái	đ oái
đoan	đ oan
đoàn	đ oàn
đoản	đ oản
đoán	đ oán
đoạn	đ oạn
đoàng	đ oàng
đoảng	đ oảng
đoành	đ oành
đoạt	đ oạt
đóc	đ óc
đọc	đ ọc
độc	đ ộc
đốc	đ ốc
đoi	đ oi
đòi	đ òi
đỏi	đ ỏi
đói	đ ói
đọi	đ ọi
đội	đ ội
đồi	đ ồi
đổi	đ ổi
đỗi	đ ỗi
đối	đ ối
đời	đ ời
đới	đ ới
đợi	đ ợi
đom	đ om
đòm	đ òm
đỏm	đ ỏm
đóm	đ óm
đồm	đ ồm
đốm	đ ốm
đờm	đ ờm
đởm	đ ởm
đon	đ on
đòn	đ òn
đón	đ ón
đọn	đ ọn
độn	đ ộn
đồn	đ ồn
đốn	đ ốn
đờn	đ ờn
đởn	đ ởn
đớn	đ ớn
đong	đ ong
đòng	đ òng
đỏng	đ ỏng
đóng	đ óng
đọng	đ ọng
động	đ ộng
đồng	đ ồng
đổng	đ ổng
đống	đ ống
đoòng	đ oòng
đóp	đ óp
đọp	đ ọp
độp	đ ộp
đốp	đ ốp
đớp	đ ớp
đợp	đ ợp
đót	đ ót
đọt	đ ọt
đột	đ ột
đốt	đ ốt
đớt	đ ớt
đợt	đ ợt
đô	đ ô
đôi	đ ôi
đôm	đ ôm
đôn	đ ôn
đông	đ ông
đơ	đ ơ
đơm	đ ơm
đơn	đ ơn
đu	đ u
đù	đ ù
đủ	đ ủ
đú	đ ú
đụ	đ ụ
đừ	đ ừ
đứ	đ ứ
đự	đ ự
đua	đ ua
đùa	đ ùa
đũa	đ ũa
đúa	đ úa
đứa	đ ứa
đúc	đ úc
đục	đ ục
đức	đ ức
đực	đ ực
đuề	đ uề
đui	đ ui
đùi	đ ùi
đủi	đ ủi
đũi	đ ũi
đúi	đ úi
đụi	đ ụi
đum	đ um
đùm	đ ùm
đúm	đ úm
đừm	đ ừm
đun	đ un
đùn	đ ùn
đủn	đ ủn
đụn	đ ụn
đừn	đ ừn
đung	đ ung
đùng	đ ùng
đủng	đ ủng
đũng	đ ũng
đúng	đ úng
đụng	đ ụng
đừng	đ ừng
đứng	đ ứng
đựng	đ ựng
đuốc	đ uốc
đuổi	đ uổi
đuối	đ uối
đuống	đ uống
đuôi	đ uôi
đuông	đ uông
đúp	đ úp
đụp	đ ụp
đút	đ út
đụt	đ ụt
đứt	đ ứt
đũy	đ ũy
đư	đ ư
đưa	đ ưa
đưi	đ ưi
đưm	đ ưm
đưn	đ ưn
đưng	đ ưng
đước	đ ước
được	đ ược
đười	đ ười
đượi	đ ượi
đượm	đ ượm
đường	đ ường
đươi	đ ươi
đương	đ ương
e	e
è	è
ẻ	ẻ
é	é
ẹ	ẹ
ệ	ệ
ề	ề
ể	ể
ế	ế
éc	éc
ẹc	ẹc
ệch	ệch
ếch	ếch
em	em
èm	èm
ém	ém
ếm	ếm
en	en
èn	èn
ẻn	ẻn
én	én
eng	eng
ềnh	ềnh
ễnh	ễnh
eo	eo
èo	èo
ẻo	ẻo
éo	éo
ẹo	ẹo
ép	ép
ẹp	ẹp
ét	ét
ẹt	ẹt
ệt	ệt
ết	ết
ê	ê
êm	êm
ên	ên
ênh	ênh
êu	êu
ga	g a
gà	g à
gả	g ả
gã	g ã
gá	g á
gạ	g ạ
gác	g ác
gạc	g ạc
gắc	g ắc
gấc	g ấc
gách	g ách
gạch	g ạch
gai	g ai
gài	g ài
gải	g ải
gãi	g ãi
gái	g ái
gam	g am
gặm	g ặm
gậm	g ậm
gằm	g ằm
gắm	g ắm
gầm	g ầm
gẫm	g ẫm
gấm	g ấm
gan	g an
gàn	g àn
gán	g án
gạn	g ạn
gằn	g ằn
gắn	g ắn
gần	g ần
gang	g ang
gàng	g àng
gặng	g ặng
gằng	g ằng
gắng	g ắng
ganh	g anh
gành	g ành
gánh	g ánh
gao	g ao
gào	g ào
gáo	g áo
gạo	g ạo
gáp	g áp
gặp	g ặp
gập	g ập
gắp	g ắp
gấp	g ấp
gát	g át
gạt	g ạt
gặt	g ặt
gật	g ật
gắt	g ắt
gàu	g àu
gầu	g ầu
gẫu	g ẫu
gấu	g ấu
gay	g ay
gày	g ày
gảy	g ảy
gãy	g ãy
gáy	g áy
gậy	g ậy
gầy	g ầy
gẩy	g ẩy
gẫy	g ẫy
gấy	g ấy
găm	g ăm
găn	g ăn
găng	g ăng
gâm	g âm
gân	g ân
gâu	g âu
gây	g ây
gem	g em
gen	g en
geng	g eng
gêm	g êm
gên	g ên
gênh	g ênh
gêu	g êu
ghe	gh e
ghẻ	gh ẻ
ghẽ	gh ẽ
ghé	gh é
ghẹ	gh ẹ
ghệ	gh ệ
ghề	gh ề
ghế	gh ế
ghém	gh ém
ghen	gh en
ghềnh	gh ềnh
ghẹo	gh ẹo
ghép	gh ép
ghét	gh ét
ghết	gh ết
ghê	gh ê
ghi	gh i
ghì	gh ì
ghiếc	gh iếc
ghiền	gh iền
ghim	gh im
ghìm	gh ìm
gì	g ì
gỉ	g ỉ
gí	g í
gia	gi a
già	gi à
giả	gi ả
giã	gi ã
giá	gi á
giạ	gi ạ
giác	gi ác
giặc	gi ặc
giắc	gi ắc
giấc	gi ấc
giai	gi ai
giải	gi ải
giãi	gi ãi
giam	gi am
giảm	gi ảm
giám	gi ám
giặm	gi ặm
giậm	gi ậm
giầm	gi ầm
giẫm	gi ẫm
giấm	gi ấm
gian	gi an
giàn	gi àn
giản	gi ản
giãn	gi ãn
gián	gi án
giận	gi ận
giần	gi ần
giang	gi ang
giàng	gi àng
giảng	gi ảng
giáng	gi áng
giằng	gi ằng
gianh	gi anh
giành	gi ành
giao	gi ao
giảo	gi ảo
giáo	gi áo
giáp	gi áp
giập	gi ập
giấp	gi ấp
giát	gi át
giặt	gi ặt
giật	gi ật
giắt	gi ắt
giàu	gi àu
giậu	gi ậu
giầu	gi ầu
giấu	gi ấu
giày	gi ày
giãy	gi ãy
giáy	gi áy
giầy	gi ầy
giẫy	gi ẫy
giấy	gi ấy
giăm	gi ăm
giăng	gi ăng
giâm	gi âm
giây	gi ây
giẻ	gi ẻ
giẽ	gi ẽ
giéc	gi éc
giẹc	gi ẹc
gièm	gi èm
giếm	gi ếm
gien	gi en
giềng	gi ềng
giếng	gi ếng
giềnh	gi ềnh
gieo	gi eo
giết	gi ết
giễu	gi ễu
giê	gi ê
giêng	gi êng
gìn	g ìn
giò	gi ò
giỏ	gi ỏ
gió	gi ó
giỗ	gi ỗ
giờ	gi ờ
giở	gi ở
gioăng	gi oăng
gióc	gi óc
giốc	gi ốc
giòi	gi òi
giỏi	gi ỏi
giõi	gi õi
giói	gi ói
giọi	gi ọi
giời	gi ời
giới	gi ới
giòm	gi òm
giỏm	gi ỏm
giòn	gi òn
giỡn	gi ỡn
giòng	gi òng
giỏng	gi ỏng
gióng	gi óng
giọng	gi ọng
giồng	gi ồng
giống	gi ống
gioóc	gi oóc
giọt	gi ọt
giô	gi ô
giôn	gi ôn
giông	gi ông
giơ	gi ơ
giũ	gi ũ
giữ	gi ữ
giũa	gi ũa
giúa	gi úa
giụa	gi ụa
giữa	gi ữa
giục	gi ục
giúi	gi úi
gium	gi um
giùm	gi ùm
giun	gi un
giuộc	gi uộc
giúp	gi úp
giựt	gi ựt
giường	gi ường
giương	gi ương
go	g o
gò	g ò
gõ	g õ
gồ	g ồ
gổ	g ổ
gỗ	g ỗ
gờ	g ờ
gở	g ở
gỡ	g ỡ
góa	g óa
goai	g oai
goát	g oát
goay	g oay
góc	g óc
gộc	g ộc
gốc	g ốc
goeo	g oeo
goép	g oép
gỏi	g ỏi
gói	g ói
gọi	g ọi
gội	g ội
gối	g ối
gởi	g ởi
gới	g ới
gợi	g ợi
gom	g om
gồm	g ồm
gốm	g ốm
gờm	g ờm
gớm	g ớm
gợm	g ợm
gòn	g òn
gọn	g ọn
gờn	g ờn
gợn	g ợn
gong	g ong
gòng	g òng
gỏng	g ỏng
gọng	g ọng
gồng	g ồng
goóc	g oóc
goọc	g oọc
góp	g óp
gộp	g ộp
gót	g ót
gọt	g ọt
gột	g ột
gô	g ô
gôm	g ôm
gôn	g ôn
gông	g ông
gơ	g ơ
gơn	g ơn
gu	g u
gù	g ù
gú	g ú
gụ	g ụ
gừ	g ừ
guây	g uây
gúc	g úc
gục	g ục
gùi	g ùi
gũi	g ũi
gụi	g ụi
gửi	g ửi
gừm	g ừm
gủng	g ủng
gừng	g ừng
guộc	g uộc
guốc	g uốc
guồng	g uồng
guốt	g uốt
guôn	g uôn
gút	g út
guy	g uy
guých	g uých
gưm	g ưm
gườm	g ườm
gượng	g ượng
gươm	g ươm
gương	g ương
ha	h a
hà	h à
hả	h ả
há	h á
hạ	h ạ
hác	h ác
hạc	h ạc
hặc	h ặc
hắc	h ắc
hách	h ách
hạch	h ạch
hai	h ai
hài	h ài
hải	h ải
hãi	h ãi
hái	h ái
hại	h ại
ham	h am
hàm	h àm
hãm	h ãm
hám	h ám
hạm	h ạm
hậm	h ậm
hằm	h ằm
hầm	h ầm
hẩm	h ẩm
han	h an
hàn	h àn
hản	h ản
hãn	h ãn
hán	h án
hạn	h ạn
hận	h ận
hằn	h ằn
hẳn	h ẳn
hắn	h ắn
hấn	h ấn
hang	h ang
hàng	h àng
hảng	h ảng
hãng	h ãng
háng	h áng
hạng	h ạng
hằng	h ằng
hẵng	h ẵng
hắng	h ắng
hẫng	h ẫng
hấng	h ấng
hanh	h anh
hành	h ành
hãnh	h ãnh
hạnh	h ạnh
hao	h ao
hào	h ào
hảo	h ảo
hão	h ão
háo	h áo
hạo	h ạo
háp	h áp
hạp	h ạp
hập	h ập
hấp	h ấp
hát	h át
hạt	h ạt
hắt	h ắt
hất	h ất
hau	h au
hàu	h àu
háu	h áu
hạu	h ạu
hậu	h ậu
hầu	h ầu
hẩu	h ẩu
hấu	h ấu
hay	h ay
hày	h ày
hảy	h ảy
hãy	h ãy
háy	h áy
hầy	h ầy
hăm	h ăm
hăn	h ăn
hăng	h ăng
hâm	h âm
hân	h ân
hâu	h âu
hây	h ây
he	h e
hè	h è
hẻ	h ẻ
hé	h é
hẹ	h ẹ
hệ	h ệ
hề	h ề
hể	h ể
hễ	h ễ
hế	h ế
héc	h éc
hệch	h ệch
hếch	h ếch
hem	h em
hèm	h èm
hẻm	h ẻm
hen	h en
hèn	h èn
hẹn	h ẹn
hển	h ển
hến	h ến
hềnh	h ềnh
heo	h eo
hèo	h èo
hẻo	h ẻo
héo	h éo
hẹo	h ẹo
hép	h ép
hẹp	h ẹp
hét	h ét
hệt	h ệt
hết	h ết
hều	h ều
hểu	h ểu
hếu	h ếu
hê	h ê
hên	h ên
hênh	h ênh
hêu	h êu
hi	h i
hì	h ì
hỉ	h ỉ
hĩ	h ĩ
hí	h í
hị	h ị
hia	h ia
híc	h íc
hích	h ích
hịch	h ịch
hiềm	h iềm
hiểm	h iểm
hiễm	h iễm
hiếm	h iếm
hiện	h iện
hiền	h iền
hiển	h iển
hiến	h iến
hiệp	h iệp
hiếp	h iếp
hiệt	h iệt
hiệu	h iệu
hiều	h iều
hiểu	h iểu
hiếu	h iếu
hiên	h iên
hiêng	h iêng
hiêu	h iêu
him	h im
hin	h in
hinh	h inh
hình	h ình
hỉnh	h ỉnh
hĩnh	h ĩnh
híp	h íp
hít	h ít
hiu	h iu
hĩu	h ĩu
ho	h o
hò	h ò
hó	h ó
họ	h ọ
hộ	h ộ
hồ	h ồ
hổ	h ổ
hỗ	h ỗ
hố	h ố
hờ	h ờ
hở	h ở
hỡ	h ỡ
hớ	h ớ
hoa	h oa
hoà	h oà
hoá	h oá
hòa	h òa
hỏa	h ỏa
hóa	h óa
họa	h ọa
hoác	h oác
hoạc	h oạc
hoặc	h oặc
hoắc	h oắc
hoạch	h oạch
hoài	h oài
hoải	h oải
hoại	h oại
hoắm	h oắm
hoan	h oan
hoàn	h oàn
hoản	h oản
hoãn	h oãn
hoán	h oán
hoạn	h oạn
hoang	h oang
hoàng	h oàng
hoảng	h oảng
hoằng	h oằng
hoẵng	h oẵng
hoanh	h oanh
hoành	h oành
hoảnh	h oảnh
hoạnh	h oạnh
hoát	h oát
hoạt	h oạt
hoắt	h oắt
hoay	h oay
hoáy	h oáy
hóc	h óc
học	h ọc
hộc	h ộc
hốc	h ốc
hoe	h oe
hòe	h òe
họe	h ọe
hoen	h oen
hoẻn	h oẻn
hoét	h oét
hoi	h oi
hòi	h òi
hỏi	h ỏi
hói	h ói
hội	h ội
hồi	h ồi
hổi	h ổi
hối	h ối
hời	h ời
hởi	h ởi
hỡi	h ỡi
hới	h ới
hợi	h ợi
hom	h om
hòm	h òm
hõm	h õm
hóm	h óm
hổm	h ổm
hớm	h ớm
hợm	h ợm
hon	h on
hòn	h òn
hỏn	h ỏn
hộn	h ộn
hồn	h ồn
hổn	h ổn
hỗn	h ỗn
hờn	h ờn
hớn	h ớn
hong	h ong
hòng	h òng
hỏng	h ỏng
hóng	h óng
họng	h ọng
hồng	h ồng
hổng	h ổng
hống	h ống
hoóc	h oóc
hóp	h óp
họp	h ọp
hộp	h ộp
hốp	h ốp
hớp	h ớp
hợp	h ợp
hót	h ót
họt	h ọt
hột	h ột
hốt	h ốt
hớt	h ớt
hợt	h ợt
hô	h ô
hôi	h ôi
hôm	h ôm
hôn	h ôn
hông	h ông
hơ	h ơ
hơi	h ơi
hơm	h ơm
hơn	h ơn
hu	h u
hù	h ù
hủ	h ủ
hũ	h ũ
hú	h ú
hụ	h ụ
hừ	h ừ
hử	h ử
hữ	h ữ
hứ	h ứ
hự	h ự
hua	h ua
hùa	h ùa
hủa	h ủa
hứa	h ứa
huẩn	h uẩn
huấn	h uấn
huân	h uân
húc	h úc
hục	h ục
hức	h ức
hực	h ực
huệ	h uệ
huề	h uề
huễ	h uễ
huế	h uế
huê	h uê
huênh	h uênh
hui	h ui
hùi	h ùi
hủi	h ủi
húi	h úi
hụi	h ụi
hùm	h ùm
hừm	h ừm
hun	h un
hùn	h ùn
hung	h ung
hùng	h ùng
húng	h úng
hừng	h ừng
hửng	h ửng
hững	h ững
hứng	h ứng
huồi	h uồi
huổi	h uổi
huống	h uống
huôn	h uôn
huông	h uông
huơ	h uơ
húp	h úp
hụp	h ụp
hút	h út
hụt	h ụt
hữu	h ữu
hựu	h ựu
huy	h uy
hủy	h ủy
húy	h úy
hụy	h ụy
huých	h uých
huỵch	h uỵch
huyện	h uyện
huyền	h uyền
huyễn	h uyễn
huyến	h uyến
huyệt	h uyệt
huyết	h uyết
huyên	h uyên
huyn	h uyn
huynh	h uynh
huỳnh	h uỳnh
huýt	h uýt
hư	h ư
hưng	h ưng
hước	h ước
hướm	h ướm
hường	h ường
hưởng	h ưởng
hướng	h ướng
hương	h ương
hươu	h ươu
hưu	h ưu
hy	h y
hỷ	h ỷ
hý	h ý
i	i
ì	ì
ỉ	ỉ
ĩ	ĩ
í	í
ị	ị
ia	ia
ỉa	ỉa
ích	ích
ịch	ịch
im	im
ỉm	ỉm
in	in
ìn	ìn
ỉn	ỉn
ín	ín
inh	inh
ình	ình
ít	ít
ịt	ịt
iu	iu
ỉu	ỉu
íu	íu
ke	k e
kè	k è
kẻ	k ẻ
kẽ	k ẽ
ké	k é
kẹ	k ẹ
kệ	k ệ
kề	k ề
kể	k ể
kế	k ế
kéc	k éc
kẹc	k ẹc
kệch	k ệch
kếch	k ếch
kem	k em
kèm	k èm
kẽm	k ẽm
kém	k ém
kềm	k ềm
ken	k en
kèn	k èn
kẻn	k ẻn
kẽn	k ẽn
kén	k én
kền	k ền
keng	k eng
kẻng	k ẻng
kềnh	k ềnh
keo	k eo
kèo	k èo
kẻo	k ẻo
kẽo	k ẽo
kéo	k éo
kẹo	k ẹo
kép	k ép
kẹp	k ẹp
kệp	k ệp
kếp	k ếp
két	k ét
kẹt	k ẹt
kết	k ết
kều	k ều
kê	k ê
kên	k ên
kênh	k ênh
kêu	k êu
kha	kh a
khà	kh à
khả	kh ả
khá	kh á
khác	kh ác
khạc	kh ạc
khặc	kh ặc
khắc	kh ắc
khách	kh ách
khai	kh ai
khài	kh ài
khải	kh ải
khái	kh ái
kham	kh am
khảm	kh ảm
khám	kh ám
khậm	kh ậm
khắm	kh ắm
khẩm	kh ẩm
khấm	kh ấm
khan	kh an
khàn	kh àn
khản	kh ản
khán	kh án
khằn	kh ằn
khắn	kh ắn
khẩn	kh ẩn
khấn	kh ấn
khang	kh ang
khàng	kh àng
khảng	kh ảng
kháng	kh áng
khạng	kh ạng
khằng	kh ằng
khẳng	kh ẳng
khắng	kh ắng
khanh	kh anh
khảnh	kh ảnh
khánh	kh ánh
khao	kh ao
khào	kh ào
khảo	kh ảo
kháo	kh áo
khạo	kh ạo
khập	kh ập
khắp	kh ắp
khấp	kh ấp
khát	kh át
khắt	kh ắt
khất	kh ất
khau	kh au
kháu	kh áu
khẩu	kh ẩu
khấu	kh ấu
khay	kh ay
khẩy	kh ẩy
khăm	kh ăm
khăn	kh ăn
khăng	kh ăng
khâm	kh âm
khân	kh ân
khâu	kh âu
khe	kh e
khè	kh è
khẽ	kh ẽ
khệ	kh ệ
khế	kh ế
khem	kh em
khen	kh en
khèn	kh èn
khén	kh én
khệnh	kh ệnh
khểnh	kh ểnh
kheo	kh eo
khèo	kh èo
khéo	kh éo
khép	kh ép
khếp	kh ếp
khét	kh ét
khều	kh ều
khê	kh ê
khênh	kh ênh
khêu	kh êu
khi	kh i
khì	kh ì
khỉ	kh ỉ
khí	kh í
khía	kh ía
khịa	kh ịa
khích	kh ích
khiếm	kh iếm
khiển	kh iển
khiến	kh iến
khiễng	kh iễng
khiếp	kh iếp
khiết	kh iết
khiếu	kh iếu
khiêm	kh iêm
khiên	kh iên
khiêng	kh iêng
khiêu	kh iêu
khin	kh in
khinh	kh inh
khỉnh	kh ỉnh
khít	kh ít
khịt	kh ịt
kho	kh o
khò	kh ò
khó	kh ó
khọ	kh ọ
khổ	kh ổ
khố	kh ố
khờ	kh ờ
khoa	kh oa
khỏa	kh ỏa
khóa	kh óa
khoác	kh oác
khoai	kh oai
khoải	kh oải
khoái	kh oái
khoằm	kh oằm
khoắm	kh oắm
khoan	kh oan
khoản	kh oản
khoán	kh oán
khoắn	kh oắn
khoang	kh oang
khoàng	kh oàng
khoảng	kh oảng
khoáng	kh oáng
khoắng	kh oắng
khoanh	kh oanh
khoảnh	kh oảnh
khoát	kh oát
khoắt	kh oắt
khoáy	kh oáy
khoăn	kh oăn
khóc	kh óc
khọc	kh ọc
khốc	kh ốc
khoe	kh oe
khoẻ	kh oẻ
khỏe	kh ỏe
khóe	kh óe
khoeo	kh oeo
khoèo	kh oèo
khoét	kh oét
khỏi	kh ỏi
khói	kh ói
khối	kh ối
khởi	kh ởi
khom	kh om
khòm	kh òm
khóm	kh óm
khọm	kh ọm
khon	kh on
khốn	kh ốn
khòng	kh òng
khổng	kh ổng
khống	kh ống
khộp	kh ộp
khớp	kh ớp
khợp	kh ợp
khọt	kh ọt
khợt	kh ợt
khô	kh ô
khôi	kh ôi
khôn	kh ôn
không	kh ông
khơ	kh ơ
khơi	kh ơi
khu	kh u
khù	kh ù
khú	kh ú
khụ	kh ụ
khử	kh ử
khứ	kh ứ
khự	kh ự
khua	kh ua
khùa	kh ùa
khửa	kh ửa
khứa	kh ứa
khựa	kh ựa
khuẩn	kh uẩn
khuất	kh uất
khuấy	kh uấy
khuân	kh uân
khuâng	kh uâng
khuây	kh uây
khúc	kh úc
khục	kh ục
khực	kh ực
khuếch	kh uếch
khuê	kh uê
khui	kh ui
khum	kh um
khủm	kh ủm
khúm	kh úm
khung	kh ung
khùng	kh ùng
khủng	kh ủng
khựng	kh ựng
khuổi	kh uổi
khuôn	kh uôn
khuông	kh uông
khuy	kh uy
khụy	kh ụy
khuya	kh uya
khuyển	kh uyển
khuyến	kh uyến
khuyết	kh uyết
khuyên	kh uyên
khuynh	kh uynh
khuỷu	kh uỷu
khư	kh ư
khưa	kh ưa
khước	kh ước
khường	kh ường
khướt	kh ướt
khướu	kh ướu
khương	kh ương
khưu	kh ưu
ki	k i
kì	k ì
kỉ	k ỉ
kĩ	k ĩ
kí	k í
kị	k ị
kia	k ia
kìa	k ìa
kích	k ích
kịch	k ịch
kiếc	k iếc
kiệm	k iệm
kiềm	k iềm
kiểm	k iểm
kiếm	k iếm
kiện	k iện
kiền	k iền
kiển	k iển
kiến	k iến
kiềng	k iềng
kiểng	k iểng
kiễng	k iễng
kiếng	k iếng
kiếp	k iếp
kiệt	k iệt
kiết	k iết
kiệu	k iệu
kiều	k iều
kiểu	k iểu
kiếu	k iếu
kiêm	k iêm
kiên	k iên
kiêng	k iêng
kiêu	k iêu
kim	k im
kìm	k ìm
kin	k in
kìn	k ìn
kín	k ín
kinh	k inh
kình	k ình
kỉnh	k ỉnh
kính	k ính
kíp	k íp
kịp	k ịp
kít	k ít
kịt	k ịt
kỳ	k ỳ
kỷ	k ỷ
kỹ	k ỹ
ký	k ý
kỵ	k ỵ
la	l a
là	l à
lả	l ả
lã	l ã
lá	l á
lạ	l ạ
lác	l ác
lạc	l ạc
lặc	l ặc
lắc	l ắc
lấc	l ấc
lách	l ách
lạch	l ạch
lai	l ai
lài	l ài
lải	l ải
lãi	l ãi
lái	l ái
lại	l ại
lam	l am
làm	l àm
lảm	l ảm
lãm	l ãm
lạm	l ạm
lặm	l ặm
lậm	l ậm
lằm	l ằm
lắm	l ắm
lầm	l ầm
lẩm	l ẩm
lẫm	l ẫm
lấm	l ấm
lan	l an
làn	l àn
lãn	l ãn
lán	l án
lạn	l ạn
lặn	l ặn
lận	l ận
lằn	l ằn
lẳn	l ẳn
lắn	l ắn
lần	l ần
lẩn	l ẩn
lẫn	l ẫn
lấn	l ấn
lang	l ang
làng	l àng
lảng	l ảng
lãng	l ãng
láng	l áng
lạng	l ạng
lặng	l ặng
lằng	l ằng
lẳng	l ẳng
lẵng	l ẵng
lắng	l ắng
lấng	l ấng
lanh	l anh
lành	l ành
lảnh	l ảnh
lãnh	l ãnh
lánh	l ánh
lạnh	l ạnh
lao	l ao
lào	l ào
lảo	l ảo
lão	l ão
láo	l áo
lạo	l ạo
láp	l áp
lạp	l ạp
lặp	l ặp
lập	l ập
lắp	l ắp
lấp	l ấp
lát	l át
lạt	l ạt
lặt	l ặt
lật	l ật
lắt	l ắt
lất	l ất
lau	l au
làu	l àu
lảu	l ảu
láu	l áu
lậu	l ậu
lầu	l ầu
lẩu	l ẩu
lấu	l ấu
lay	l ay
lày	l ày
láy	l áy
lạy	l ạy
lậy	l ậy
lầy	l ầy
lẩy	l ẩy
lẫy	l ẫy
lấy	l ấy
lăm	l ăm
lăn	l ăn
lăng	l ăng
lâm	l âm
lân	l ân
lâng	l âng
lâu	l âu
lây	l ây
le	l e
lè	l è
lẻ	l ẻ
lẽ	l ẽ
lé	l é
lẹ	l ẹ
lệ	l ệ
lề	l ề
lể	l ể
lễ	l ễ
lế	l ế
léc	l éc
lệch	l ệch
lếch	l ếch
lem	l em
lèm	l èm
lém	l ém
lẹm	l ẹm
len	l en
lèn	l èn
lẻn	l ẻn
lẽn	l ẽn
lén	l én
lến	l ến
leng	l eng
lèng	l èng
léng	l éng
lệnh	l ệnh
lềnh	l ềnh
leo	l eo
lèo	l èo
lẻo	l ẻo
lẽo	l ẽo
léo	l éo
lẹo	l ẹo
lép	l ép
lét	l ét
lẹt	l ẹt
lệt	l ệt
lết	l ết
lều	l ều
lếu	l ếu
lê	l ê
lên	l ên
lênh	l ênh
lêu	l êu
li	l i
lì	l ì
lí	l í
lị	l ị
lia	l ia
lìa	l ìa
lía	l ía
lịa	l ịa
lích	l ích
lịch	l ịch
liếc	l iếc
liệm	l iệm
liềm	l iềm
liễm	l iễm
liếm	l iếm
liện	l iện
liền	l iền
liễn	l iễn
liến	l iến
liệng	l iệng
liểng	l iểng
liếng	l iếng
liệp	l iệp
liếp	l iếp
liệt	l iệt
liệu	l iệu
liều	l iều
liễu	l iễu
liêm	l iêm
liên	l iên
liêng	l iêng
liêu	l iêu
lim	l im
lìm	l ìm
lịm	l ịm
lin	l in
lìn	l ìn
linh	l inh
lình	l ình
lỉnh	l ỉnh
lĩnh	l ĩnh
lính	l ính
lịnh	l ịnh
líp	l íp
lít	l ít
lịt	l ịt
liu	l iu
lìu	l ìu
lỉu	l ỉu
lĩu	l ĩu
líu	l íu
lịu	l ịu
lo	l o
lò	l ò
lõ	l õ
ló	l ó
lọ	l ọ
lộ	l ộ
lồ	l ồ
lổ	l ổ
lỗ	l ỗ
lố	l ố
lờ	l ờ
lở	l ở
lỡ	l ỡ
lớ	l ớ
lợ	l ợ
loa	l oa
lòa	l òa
lõa	l õa
lóa	l óa
loắc	l oắc
loài	l oài
loại	l oại
loan	l oan
loàn	l oàn
loạn	l oạn
loằn	l oằn
loang	l oang
loảng	l oảng
loãng	l oãng
loáng	l oáng
loạng	l oạng
loằng	l oằng
loanh	l oanh
loát	l oát
loạt	l oạt
loay	l oay
loăng	l oăng
lóc	l óc
lọc	l ọc
lộc	l ộc
lốc	l ốc
loe	l oe
loé	l oé
lòe	l òe
lóe	l óe
loét	l oét
loẹt	l oẹt
loi	l oi
lòi	l òi
lỏi	l ỏi
lõi	l õi
lói	l ói
lọi	l ọi
lội	l ội
lồi	l ồi
lỗi	l ỗi
lối	l ối
lời	l ời
lởi	l ởi
lới	l ới
lợi	l ợi
lom	l om
lòm	l òm
lỏm	l ỏm
lõm	l õm
lóm	l óm
lọm	l ọm
lồm	l ồm
lổm	l ổm
lốm	l ốm
lờm	l ờm
lởm	l ởm
lợm	l ợm
lon	l on
lòn	l òn
lỏn	l ỏn
lọn	l ọn
lộn	l ộn
lồn	l ồn
lổn	l ổn
lốn	l ốn
lờn	l ờn
lởn	l ởn
lỡn	l ỡn
lớn	l ớn
lợn	l ợn
long	l ong
lòng	l òng
lỏng	l ỏng
lõng	l õng
lóng	l óng
lọng	l ọng
lộng	l ộng
lồng	l ồng
lổng	l ổng
lống	l ống
loóc	l oóc
lóp	l óp
lộp	l ộp
lốp	l ốp
lớp	l ớp
lợp	l ợp
lót	l ót
lọt	l ọt
lột	l ột
lốt	l ốt
lớt	l ớt
lợt	l ợt
lô	l ô
lôi	l ôi
lôm	l ôm
lôn	l ôn
lông	l ông
lơ	l ơ
lơi	l ơi
lơn	l ơn
lu	l u
lù	l ù
lũ	l ũ
lú	l ú
lụ	l ụ
lừ	l ừ
lữ	l ữ
lự	l ự
lua	l ua
lùa	l ùa
lũa	l ũa
lúa	l úa
lụa	l ụa
lừa	l ừa
lửa	l ửa
lữa	l ữa
lứa	l ứa
lựa	l ựa
luận	l uận
luẩn	l uẩn
luật	l uật
luân	l uân
lúc	l úc
lục	l ục
lức	l ức
lực	l ực
lui	l ui
lùi	l ùi
lủi	l ủi
lũi	l ũi
lúi	l úi
lụi	l ụi
lum	l um
lùm	l ùm
lúm	l úm
lụm	l ụm
lun	l un
lùn	l ùn
lủn	l ủn
lũn	l ũn
lún	l ún
lụn	l ụn
lung	l ung
lùng	l ùng
lủng	l ủng
lũng	l ũng
lúng	l úng
lụng	l ụng
lừng	l ừng
lửng	l ửng
lững	l ững
lứng	l ứng
lựng	l ựng
luộc	l uộc
luốc	l uốc
luộm	l uộm
luồn	l uồn
luồng	l uồng
luống	l uống
luôn	l uôn
luông	l uông
lúp	l úp
lụp	l ụp
lút	l út
lụt	l ụt
lứt	l ứt
lựu	l ựu
luy	l uy
lũy	l ũy
lúy	l úy
lụy	l ụy
luyện	l uyện
luyến	l uyến
luyên	l uyên
lư	l ư
lưa	l ưa
lưng	l ưng
lược	l ược
lười	l ười
lưỡi	l ưỡi
lưới	l ưới
lườm	l ườm
lượm	l ượm
lườn	l ườn
lượn	l ượn
lường	l ường
lưỡng	l ưỡng
lượng	l ượng
lượp	l ượp
lướt	l ướt
lượt	l ượt
lươn	l ươn
lương	l ương
lưu	l ưu
ly	l y
lỳ	l ỳ
lý	l ý
lỵ	l ỵ
ma	m a
mà	m à
mả	m ả
mã	m ã
má	m á
mạ	m ạ
mác	m ác
mạc	m ạc
mặc	m ặc
mắc	m ắc
mách	m ách
mạch	m ạch
mai	m ai
mài	m ài
mải	m ải
mãi	m ãi
mái	m ái
mại	m ại
mạm	m ạm
mắm	m ắm
mầm	m ầm
mẩm	m ẩm
mẫm	m ẫm
man	m an
màn	m àn
mản	m ản
mãn	m ãn
mán	m án
mạn	m ạn
mặn	m ặn
mận	m ận
mằn	m ằn
mắn	m ắn
mần	m ần
mẩn	m ẩn
mẫn	m ẫn
mấn	m ấn
mang	m ang
màng	m àng
mảng	m ảng
mãng	m ãng
máng	m áng
mạng	m ạng
mắng	m ắng
manh	m anh
mành	m ành
mảnh	m ảnh
mãnh	m ãnh
mánh	m ánh
mạnh	m ạnh
mao	m ao
mào	m ào
mão	m ão
máo	m áo
mạo	m ạo
máp	m áp
mạp	m ạp
mập	m ập
mấp	m ấp
mát	m át
mạt	m ạt
mặt	m ặt
mật	m ật
mắt	m ắt
mất	m ất
mau	m au
màu	m àu
máu	m áu
mậu	m ậu
mầu	m ầu
mẩu	m ẩu
mẫu	m ẫu
mấu	m ấu
may	m ay
mày	m ày
mảy	m ảy
máy	m áy
mạy	m ạy
mầy	m ầy
mẩy	m ẩy
mấy	m ấy
măm	m ăm
măn	m ăn
măng	m ăng
mâm	m âm
mân	m ân
mâu	m âu
mây	m ây
me	m e
mè	m è
mẻ	m ẻ
mẽ	m ẽ
mé	m é
mẹ	m ẹ
mệ	m ệ
mề	m ề
mễ	m ễ
mế	m ế
méc	m éc
mẹc	m ẹc
mếch	m ếch
mem	m em
mèm	m èm
mém	m ém
mềm	m ềm
men	m en
mèn	m èn
mén	m én
mền	m ền
mến	m ến
mệnh	m ệnh
meo	m eo
mèo	m èo
mẽo	m ẽo
méo	m éo
mẹo	m ẹo
mép	m ép
mẹp	m ẹp
mét	m ét
mẹt	m ẹt
mệt	m ệt
mết	m ết
mếu	m ếu
mê	m ê
mên	m ên
mênh	m ênh
mi	m i
mì	m ì
mỉ	m ỉ
mĩ	m ĩ
mí	m í
mị	m ị
mia	m ia
mìa	m ìa
mỉa	m ỉa
mĩa	m ĩa
mía	m ía
mịa	m ịa
míc	m íc
mích	m ích
mịch	m ịch
miện	m iện
miền	m iền
miễn	m iễn
miến	m iến
miệng	m iệng
miếng	m iếng
miệt	m iệt
miết	m iết
miều	m iều
miễu	m iễu
miếu	m iếu
miên	m iên
miêng	m iêng
miêu	m iêu
mỉm	m ỉm
mĩm	m ĩm
mím	m ím
min	m in
mìn	m ìn
mịn	m ịn
minh	m inh
mình	m ình
mĩnh	m ĩnh
mính	m ính
míp	m íp
mít	m ít
mịt	m ịt
miu	m iu
mo	m o
mò	m ò
mỏ	m ỏ
mõ	m õ
mó	m ó
mọ	m ọ
mộ	m ộ
mồ	m ồ
mổ	m ổ
mỗ	m ỗ
mố	m ố
mờ	m ờ
mở	m ở
mỡ	m ỡ
mớ	m ớ
mợ	m ợ
moa	m oa
móa	m óa
moai	m oai
móc	m óc
mọc	m ọc
mộc	m ộc
mốc	m ốc
moi	m oi
mòi	m òi
mỏi	m ỏi
mói	m ói
mọi	m ọi
mội	m ội
mồi	m ồi
mỗi	m ỗi
mối	m ối
mời	m ời
mởi	m ởi
mới	m ới
mom	m om
mỏm	m ỏm
mõm	m õm
móm	m óm
mồm	m ồm
mớm	m ớm
mon	m on
mòn	m òn
món	m ón
mọn	m ọn
mồn	m ồn
mởn	m ởn
mớn	m ớn
mong	m ong
mòng	m òng
mỏng	m ỏng
móng	m óng
mọng	m ọng
mộng	m ộng
mồng	m ồng
mống	m ống
moóc	m oóc
moong	m oong
móp	m óp
mót	m ót
mọt	m ọt
một	m ột
mốt	m ốt
mớt	m ớt
mợt	m ợt
mô	m ô
môi	m ôi
môn	m ôn
mông	m ông
mơ	m ơ
mơi	m ơi
mơn	m ơn
mu	m u
mù	m ù
mủ	m ủ
mũ	m ũ
mú	m ú
mụ	m ụ
mừ	m ừ
mứ	m ứ
mua	m ua
mùa	m ùa
mủa	m ủa
múa	m úa
mửa	m ửa
mứa	m ứa
múc	m úc
mục	m ục
mức	m ức
mực	m ực
mui	m ui
mùi	m ùi
mủi	m ủi
mũi	m ũi
múi	m úi
mum	m um
mũm	m ũm
múm	m úm
mun	m un
mùn	m ùn
mủn	m ủn
mũn	m ũn
mún	m ún
mụn	m ụn
mừn	m ừn
mứn	m ứn
mung	m ung
mùng	m ùng
mủng	m ủng
mừng	m ừng
muội	m uội
muồi	m uồi
muổi	m uổi
muỗi	m uỗi
muối	m uối
muộn	m uộn
muốn	m uốn
muồng	m uồng
muỗng	m uỗng
muống	m uống
muốt	m uốt
muôi	m uôi
muôn	m uôn
muông	m uông
múp	m úp
mụp	m ụp
mút	m út
mứt	m ứt
mư	m ư
mưa	m ưa
mưng	m ưng
mười	m ười
mưởi	m ưởi
mướn	m ướn
mượn	m ượn
mường	m ường
mướp	m ướp
mướt	m ướt
mượt	m ượt
mươi	m ươi
mươn	m ươn
mương	m ương
mưu	m ưu
my	m y
mỳ	m ỳ
mỷ	m ỷ
mỹ	m ỹ
mỵ	m ỵ
na	n a
nà	n à
nả	n ả
nã	n ã
ná	n á
nạ	n ạ
nác	n ác
nạc	n ạc
nặc	n ặc
nắc	n ắc
nấc	n ấc
nách	n ách
nai	n ai
nài	n ài
nải	n ải
nãi	n ãi
nái	n ái
nại	n ại
nam	n am
nàm	n àm
nám	n ám
nạm	n ạm
nặm	n ặm
nậm	n ậm
nằm	n ằm
nẳm	n ẳm
nắm	n ắm
nầm	n ầm
nấm	n ấm
nan	n an
nàn	n àn
nản	n ản
nán	n án
nạn	n ạn
nặn	n ặn
nằn	n ằn
nắn	n ắn
nần	n ần
nấn	n ấn
nang	n ang
nàng	n àng
náng	n áng
nạng	n ạng
nặng	n ặng
nằng	n ằng
nẵng	n ẵng
nắng	n ắng
nẫng	n ẫng
nấng	n ấng
nanh	n anh
nành	n ành
nánh	n ánh
nạnh	n ạnh
nao	n ao
nào	n ào
não	n ão
náo	n áo
nạo	n ạo
nạp	n ạp
nập	n ập
nắp	n ắp
nấp	n ấp
nát	n át
nạt	n ạt
nắt	n ắt
náu	n áu
nậu	n ậu
nầu	n ầu
nẫu	n ẫu
nấu	n ấu
nay	n ay
này	n ày
nảy	n ảy
nãy	n ãy
náy	n áy
nạy	n ạy
nầy	n ầy
nẩy	n ẩy
nẫy	n ẫy
nấy	n ấy
năm	n ăm
năn	n ăn
năng	n ăng
nâm	n âm
nâng	n âng
nâu	n âu
nây	n ây
ne	n e
nè	n è
nẻ	n ẻ
né	n é
nệ	n ệ
nề	n ề
nể	n ể
néc	n éc
nẹc	n ẹc
nếch	n ếch
nem	n em
ném	n ém
nệm	n ệm
nếm	n ếm
nen	n en
nèn	n èn
nén	n én
nện	n ện
nền	n ền
nến	n ến
neo	n eo
nèo	n èo
nẻo	n ẻo
néo	n éo
nẹo	n ẹo
nép	n ép
nẹp	n ẹp
nệp	n ệp
nếp	n ếp
nét	n ét
nẹt	n ẹt
nết	n ết
nếu	n ếu
nê	n ê
nêm	n êm
nên	n ên
nêu	n êu
nga	ng a
ngà	ng à
ngả	ng ả
ngã	ng ã
ngác	ng ác
ngạc	ng ạc
ngắc	ng ắc
ngách	ng ách
ngạch	ng ạch
ngai	ng ai
ngài	ng ài
ngải	ng ải
ngãi	ng ãi
ngái	ng ái
ngại	ng ại
ngàm	ng àm
ngậm	ng ậm
ngằm	ng ằm
ngắm	ng ắm
ngầm	ng ầm
ngẩm	ng ẩm
ngẫm	ng ẫm
ngấm	ng ấm
ngan	ng an
ngàn	ng àn
ngán	ng án
ngạn	ng ạn
ngằn	ng ằn
ngắn	ng ắn
ngần	ng ần
ngẩn	ng ẩn
ngẫn	ng ẫn
ngấn	ng ấn
ngang	ng ang
ngàng	ng àng
ngáng	ng áng
ngẩng	ng ẩng
ngành	ng ành
ngạnh	ng ạnh
ngao	ng ao
ngào	ng ào
ngáo	ng áo
ngạo	ng ạo
ngáp	ng áp
ngập	ng ập
ngấp	ng ấp
ngát	ng át
ngạt	ng ạt
ngặt	ng ặt
ngật	ng ật
ngắt	ng ắt
ngất	ng ất
ngàu	ng àu
ngậu	ng ậu
ngầu	ng ầu
ngẫu	ng ẫu
ngấu	ng ấu
ngay	ng ay
ngày	ng ày
ngáy	ng áy
ngậy	ng ậy
ngầy	ng ầy
ngấy	ng ấy
ngăm	ng ăm
ngăn	ng ăn
ngâm	ng âm
ngân	ng ân
ngâu	ng âu
ngây	ng ây
ngếu	ng ếu
ngêu	ng êu
nghe	ngh e
nghè	ngh è
nghé	ngh é
nghẹ	ngh ẹ
nghệ	ngh ệ
nghề	ngh ề
nghễ	ngh ễ
nghệch	ngh ệch
nghếch	ngh ếch
nghen	ngh en
nghèn	ngh èn
nghẻn	ngh ẻn
nghẽn	ngh ẽn
nghén	ngh én
nghẹn	ngh ẹn
nghèng	ngh èng
nghẻng	ngh ẻng
nghẽng	ngh ẽng
nghéng	ngh éng
nghẹng	ngh ẹng
nghèo	ngh èo
nghẻo	ngh ẻo
nghẽo	ngh ẽo
nghéo	ngh éo
nghét	ngh ét
nghẹt	ngh ẹt
nghệt	ngh ệt
nghê	ngh ê
nghênh	ngh ênh
nghêu	ngh êu
nghi	ngh i
nghì	ngh ì
nghỉ	ngh ỉ
nghĩ	ngh ĩ
nghị	ngh ị
nghĩa	ngh ĩa
nghía	ngh ía
nghịch	ngh ịch
nghiệm	ngh iệm
nghiễm	ngh iễm
nghiện	ngh iện
nghiền	ngh iền
nghiến	ngh iến
nghiệp	ngh iệp
nghiệt	ngh iệt
nghiêm	ngh iêm
nghiên	ngh iên
nghiêng	ngh iêng
nghiêu	ngh iêu
nghỉm	ngh ỉm
nghìn	ngh ìn
nghĩnh	ngh ĩnh
nghịt	ngh ịt
nghỉu	ngh ỉu
nghịu	ngh ịu
ngo	ng o
ngò	ng ò
ngỏ	ng ỏ
ngõ	ng õ
ngó	ng ó
ngọ	ng ọ
ngộ	ng ộ
ngồ	ng ồ
ngổ	ng ổ
ngỗ	ng ỗ
ngố	ng ố
ngờ	ng ờ
ngỡ	ng ỡ
ngớ	ng ớ
ngợ	ng ợ
ngoa	ng oa
ngọa	ng ọa
ngoác	ng oác
ngoặc	ng oặc
ngoắc	ng oắc
ngoai	ng oai
ngoài	ng oài
ngoải	ng oải
ngoái	ng oái
ngoại	ng oại
ngoạm	ng oạm
ngoặm	ng oặm
ngoan	ng oan
ngoãn	ng oãn
ngoạn	ng oạn
ngoằn	ng oằn
ngoằng	ng oằng
ngoảnh	ng oảnh
ngoặt	ng oặt
ngoắt	ng oắt
ngoáy	ng oáy
ngóc	ng óc
ngọc	ng ọc
ngốc	ng ốc
ngoèo	ng oèo
ngoét	ng oét
ngoi	ng oi
ngòi	ng òi
ngói	ng ói
ngồi	ng ồi
ngời	ng ời
ngợi	ng ợi
ngòm	ng òm
ngỏm	ng ỏm
ngóm	ng óm
ngổm	ng ổm
ngợm	ng ợm
ngon	ng on
ngòn	ng òn
ngón	ng ón
ngọn	ng ọn
ngộn	ng ộn
ngồn	ng ồn
ngổn	ng ổn
ngốn	ng ốn
ngỏng	ng ỏng
ngóng	ng óng
ngọng	ng ọng
ngồng	ng ồng
ngỗng	ng ỗng
ngóp	ng óp
ngộp	ng ộp
ngớp	ng ớp
ngợp	ng ợp
ngót	ng ót
ngọt	ng ọt
ngột	ng ột
ngớt	ng ớt
ngô	ng ô
ngôi	ng ôi
ngôn	ng ôn
ngông	ng ông
ngơ	ng ơ
ngơi	ng ơi
ngơm	ng ơm
ngu	ng u
ngủ	ng ủ
ngũ	ng ũ
ngụ	ng ụ
ngừ	ng ừ
ngữ	ng ữ
ngự	ng ự
ngụa	ng ụa
ngừa	ng ừa
ngửa	ng ửa
ngứa	ng ứa
ngựa	ng ựa
nguậy	ng uậy
nguẩy	ng uẩy
nguấy	ng uấy
nguây	ng uây
ngục	ng ục
ngực	ng ực
nguệch	ng uệch
ngùi	ng ùi
ngủi	ng ủi
ngửi	ng ửi
ngụm	ng ụm
ngùn	ng ùn
ngủn	ng ủn
ngùng	ng ùng
ngúng	ng úng
ngừng	ng ừng
nguội	ng uội
nguồn	ng uồn
nguốt	ng uốt
nguôi	ng uôi
nguôn	ng uôn
ngụp	ng ụp
ngút	ng út
ngụt	ng ụt
nguy	ng uy
ngụy	ng ụy
nguyện	ng uyện
nguyền	ng uyền
nguyễn	ng uyễn
nguyến	ng uyến
nguyệt	ng uyệt
nguyên	ng uyên
nguýt	ng uýt
ngư	ng ư
ngưng	ng ưng
ngước	ng ước
ngược	ng ược
người	ng ười
ngườm	ng ườm
ngưởng	ng ưởng
ngưỡng	ng ưỡng
ngượng	ng ượng
ngươi	ng ươi
ngươn	ng ươn
ngưu	ng ưu
nha	nh a
nhà	nh à
nhả	nh ả
nhã	nh ã
nhá	nh á
nhạ	nh ạ
nhác	nh ác
nhạc	nh ạc
nhắc	nh ắc
nhấc	nh ấc
nhách	nh ách
nhai	nh ai
nhài	nh ài
nhải	nh ải
nhãi	nh ãi
nhái	nh ái
nhại	nh ại
nham	nh am
nhàm	nh àm
nhảm	nh ảm
nhám	nh ám
nhậm	nh ậm
nhằm	nh ằm
nhắm	nh ắm
nhầm	nh ầm
nhẩm	nh ẩm
nhẫm	nh ẫm
nhấm	nh ấm
nhan	nh an
nhàn	nh àn
nhản	nh ản
nhãn	nh ãn
nhạn	nh ạn
nhặn	nh ặn
nhận	nh ận
nhằn	nh ằn
nhẵn	nh ẵn
nhắn	nh ắn
nhẩn	nh ẩn
nhẫn	nh ẫn
nhấn	nh ấn
nhang	nh ang
nhàng	nh àng
nhãng	nh ãng
nhặng	nh ặng
nhằng	nh ằng
nhẳng	nh ẳng
nhắng	nh ắng
nhanh	nh anh
nhành	nh ành
nhảnh	nh ảnh
nhánh	nh ánh
nhạnh	nh ạnh
nhao	nh ao
nhào	nh ào
nhão	nh ão
nháo	nh áo
nhạo	nh ạo
nháp	nh áp
nhập	nh ập
nhấp	nh ấp
nhát	nh át
nhạt	nh ạt
nhặt	nh ặt
nhật	nh ật
nhắt	nh ắt
nhất	nh ất
nhau	nh au
nhàu	nh àu
nhảu	nh ảu
nhậu	nh ậu
nhẩu	nh ẩu
nhay	nh ay
nhày	nh ày
nhảy	nh ảy
nháy	nh áy
nhạy	nh ạy
nhậy	nh ậy
nhầy	nh ầy
nhẩy	nh ẩy
nhẫy	nh ẫy
nhăm	nh ăm
nhăn	nh ăn
nhăng	nh ăng
nhâm	nh âm
nhân	nh ân
nhây	nh ây
nhe	nh e
nhè	nh è
nhẽ	nh ẽ
nhé	nh é
nhẹ	nh ẹ
nhề	nh ề
nhể	nh ể
nhễ	nh ễ
nhếch	nh ếch
nhem	nh em
nhèm	nh èm
nhẻm	nh ẻm
nhẹm	nh ẹm
nhen	nh en
nhẹn	nh ẹn
nhện	nh ện
nhền	nh ền
nheo	nh eo
nhèo	nh èo
nhẽo	nh ẽo
nhéo	nh éo
nhẹo	nh ẹo
nhép	nh ép
nhẹp	nh ẹp
nhét	nh ét
nhẹt	nh ẹt
nhê	nh ê
nhi	nh i
nhì	nh ì
nhỉ	nh ỉ
nhĩ	nh ĩ
nhí	nh í
nhị	nh ị
nhích	nh ích
nhiếc	nh iếc
nhiệm	nh iệm
nhiễm	nh iễm
nhiếp	nh iếp
nhiệt	nh iệt
nhiều	nh iều
nhiễu	nh iễu
nhiêm	nh iêm
nhiên	nh iên
nhiêu	nh iêu
nhím	nh ím
nhìn	nh ìn
nhín	nh ín
nhịn	nh ịn
nhỉnh	nh ỉnh
nhính	nh ính
nhíp	nh íp
nhịp	nh ịp
nhít	nh ít
nhịt	nh ịt
nhìu	nh ìu
nhíu	nh íu
nho	nh o
nhò	nh ò
nhỏ	nh ỏ
nhó	nh ó
nhọ	nh ọ
nhồ	nh ồ
nhổ	nh ổ
nhố	nh ố
nhờ	nh ờ
nhở	nh ở
nhỡ	nh ỡ
nhớ	nh ớ
nhợ	nh ợ
nhòa	nh òa
nhoài	nh oài
nhoàm	nh oàm
nhoàng	nh oàng
nhoáng	nh oáng
nhoạng	nh oạng
nhóc	nh óc
nhọc	nh ọc
nhòe	nh òe
nhoen	nh oen
nhoẻn	nh oẻn
nhoét	nh oét
nhoẹt	nh oẹt
nhoi	nh oi
nhói	nh ói
nhồi	nh ồi
nhối	nh ối
nhời	nh ời
nhom	nh om
nhòm	nh òm
nhỏm	nh ỏm
nhõm	nh õm
nhóm	nh óm
nhồm	nh ồm
nhổm	nh ổm
nhon	nh on
nhón	nh ón
nhọn	nh ọn
nhộn	nh ộn
nhổn	nh ổn
nhốn	nh ốn
nhờn	nh ờn
nhởn	nh ởn
nhỡn	nh ỡn
nhớn	nh ớn
nhong	nh ong
nhõng	nh õng
nhộng	nh ộng
nhồng	nh ồng
nhóp	nh óp
nhớp	nh ớp
nhót	nh ót
nhọt	nh ọt
nhột	nh ột
nhốt	nh ốt
nhớt	nh ớt
nhợt	nh ợt
nhô	nh ô
nhôm	nh ôm
nhôn	nh ôn
nhông	nh ông
nhơ	nh ơ
nhơn	nh ơn
nhu	nh u
nhủ	nh ủ
nhũ	nh ũ
nhú	nh ú
nhụ	nh ụ
nhừ	nh ừ
nhử	nh ử
nhữ	nh ữ
nhụa	nh ụa
nhựa	nh ựa
nhuận	nh uận
nhuần	nh uần
nhúc	nh úc
nhục	nh ục
nhức	nh ức
nhuệ	nh uệ
nhuế	nh uế
nhuên	nh uên
nhùi	nh ùi
nhủi	nh ủi
nhụi	nh ụi
nhúm	nh úm
nhùn	nh ùn
nhũn	nh ũn
nhún	nh ún
nhung	nh ung
nhùng	nh ùng
nhũng	nh ũng
nhúng	nh úng
những	nh ững
nhuốc	nh uốc
nhuộm	nh uộm
nhuốm	nh uốm
nhút	nh út
nhụt	nh ụt
nhứt	nh ứt
nhựt	nh ựt
nhụy	nh ụy
nhuyễn	nh uyễn
như	nh ư
nhưng	nh ưng
nhược	nh ược
nhường	nh ường
nhưỡng	nh ưỡng
nhượng	nh ượng
nhương	nh ương
ni	n i
nì	n ì
nỉ	n ỉ
ní	n í
nị	n ị
nia	n ia
nĩa	n ĩa
ních	n ích
nịch	n ịch
niệm	n iệm
niềm	n iềm
niền	n iền
niềng	n iềng
niễng	n iễng
niết	n iết
niệu	n iệu
niêm	n iêm
niên	n iên
niêng	n iêng
niêng	n iêng
niêu	n iêu
nin	n in
nín	n ín
ninh	n inh
nính	n ính
nịnh	n ịnh
nít	n ít
nịt	n ịt
niu	n iu
níu	n íu
nịu	n ịu
no	n o
nò	n ò
nỏ	n ỏ
nó	n ó
nọ	n ọ
nộ	n ộ
nồ	n ồ
nổ	n ổ
nỗ	n ỗ
nố	n ố
nờ	n ờ
nở	n ở
nỡ	n ỡ
nớ	n ớ
nợ	n ợ
noãn	n oãn
nóc	n óc
nọc	n ọc
nốc	n ốc
noi	n oi
nòi	n òi
nói	n ói
nọi	n ọi
nội	n ội
nồi	n ồi
nổi	n ổi
nỗi	n ỗi
nối	n ối
nới	n ới
nom	n om
nộm	n ộm
nồm	n ồm
nờm	n ờm
nỡm	n ỡm
non	n on
nõn	n õn
nón	n ón
nộn	n ộn
nong	n ong
nòng	n òng
nỏng	n ỏng
nóng	n óng
nọng	n ọng
nồng	n ồng
noóc	n oóc
noọc	n oọc
nóp	n óp
nọp	n ọp
nộp	n ộp
nớp	n ớp
nợp	n ợp
nót	n ót
nọt	n ọt
nột	n ột
nốt	n ốt
nớt	n ớt
nô	n ô
nôi	n ôi
nôm	n ôm
nôn	n ôn
nông	n ông
nơ	n ơ
nơi	n ơi
nơm	n ơm
nơn	n ơn
nu	n u
nú	n ú
nụ	n ụ
nữ	n ữ
nự	n ự
nua	n ua
nửa	n ửa
nữa	n ữa
nứa	n ứa
núc	n úc
nục	n ục
nức	n ức
nực	n ực
nui	n ui
núi	n úi
núm	n úm
nun	n un
nừn	n ừn
nung	n ung
nùng	n ùng
nũng	n ũng
núng	n úng
nứng	n ứng
nựng	n ựng
nuộc	n uộc
nuối	n uối
nuột	n uột
nuốt	n uốt
nuôi	n uôi
nuông	n uông
núp	n úp
nút	n út
nứt	n ứt
nựt	n ựt
nứu	n ứu
nuy	n uy
nư	n ư
nưa	n ưa
nưi	n ưi
nưn	n ưn
nước	n ước
nườm	n ườm
nướng	n ướng
nượp	n ượp
nướu	n ướu
nương	n ương
nưu	n ưu
o	o
ò	ò
ỏ	ỏ
ó	ó
ọ	ọ
ộ	ộ
ồ	ồ
ổ	ổ
ố	ố
ờ	ờ
ở	ở
ớ	ớ
ợ	ợ
oa	oa
òa	òa
oách	oách
oai	oai
oải	oải
oải	oải
oái	oái
oái	oái
oại	oại
oan	oan
oản	oản
oán	oán
oằn	oằn
oẳn	oẳn
oang	oang
oẳng	oẳng
oanh	oanh
oánh	oánh
oáp	oáp
oát	oát
oặt	oặt
oắt	oắt
oăm	oăm
oăn	oăn
oăng	oăng
óc	óc
ọc	ọc
ộc	ộc
ốc	ốc
oe	oe
óe	óe
ọe	ọe
oen	oen
oét	oét
oét	oét
oẹt	oẹt
oi	oi
òi	òi
ỏi	ỏi
ói	ói
ồi	ồi
ổi	ổi
ối	ối
ời	ời
ới	ới
om	om
òm	òm
ỏm	ỏm
ồm	ồm
ốm	ốm
ờm	ờm
ỡm	ỡm
on	on
òn	òn
ỏn	ỏn
ón	ón
ồn	ồn
ổn	ổn
ởn	ởn
ớn	ớn
ong	ong
ỏng	ỏng
óng	óng
ồng	ồng
ổng	ổng
ống	ống
oóc	oóc
óp	óp
ọp	ọp
ộp	ộp
ốp	ốp
ớp	ớp
ợp	ợp
ót	ót
ọt	ọt
ột	ột
ốt	ốt
ớt	ớt
ô	ô
ôi	ôi
ôm	ôm
ôn	ôn
ông	ông
ơ	ơ
ơi	ơi
ơm	ơm
ơn	ơn
pa	p a
pà	p à
pác	p ác
pấc	p ấc
pai	p ai
pan	p an
pang	p ang
pằng	p ằng
panh	p anh
páo	p áo
pát	p át
pau	p au
păn	p ăn
păng	p ăng
pây	p ây
pe	p e
pen	p en
peng	p eng
pèo	p èo
pê	p ê
pha	ph a
phà	ph à
phả	ph ả
phá	ph á
phạ	ph ạ
phác	ph ác
phạc	ph ạc
phắc	ph ắc
phách	ph ách
phạch	ph ạch
phai	ph ai
phài	ph ài
phải	ph ải
phái	ph ái
phại	ph ại
pham	ph am
phàm	ph àm
phạm	ph ạm
phầm	ph ầm
phẩm	ph ẩm
phan	ph an
phàn	ph àn
phản	ph ản
phán	ph án
phạn	ph ạn
phận	ph ận
phằn	ph ằn
phắn	ph ắn
phần	ph ần
phẩn	ph ẩn
phẫn	ph ẫn
phấn	ph ấn
phang	ph ang
phàng	ph àng
phảng	ph ảng
pháng	ph áng
phạng	ph ạng
phẳng	ph ẳng
phanh	ph anh
phành	ph ành
phao	ph ao
phào	ph ào
pháo	ph áo
pháp	ph áp
phập	ph ập
phấp	ph ấp
phát	ph át
phạt	ph ạt
phật	ph ật
phắt	ph ắt
phất	ph ất
phau	ph au
phẫu	ph ẫu
phay	ph ay
phày	ph ày
phẩy	ph ẩy
phăm	ph ăm
phăn	ph ăn
phăng	ph ăng
phân	ph ân
phâu	ph âu
phây	ph ây
phe	ph e
phè	ph è
phệ	ph ệ
phế	ph ế
phéc	ph éc
phệch	ph ệch
phếch	ph ếch
phem	ph em
phen	ph en
phèn	ph èn
phến	ph ến
pheng	ph eng
phéng	ph éng
phềnh	ph ềnh
pheo	ph eo
phèo	ph èo
phép	ph ép
phét	ph ét
phẹt	ph ẹt
phệt	ph ệt
phết	ph ết
phều	ph ều
phễu	ph ễu
phếu	ph ếu
phê	ph ê
phêm	ph êm
phên	ph ên
phêu	ph êu
phi	ph i
phì	ph ì
phỉ	ph ỉ
phí	ph í
phia	ph ia
phía	ph ía
phịa	ph ịa
phích	ph ích
phịch	ph ịch
phiếm	ph iếm
phiện	ph iện
phiền	ph iền
phiến	ph iến
phiệt	ph iệt
phiều	ph iều
phiếu	ph iếu
phiên	ph iên
phiêng	ph iêng
phiêu	ph iêu
phim	ph im
phím	ph ím
phin	ph in
phìn	ph ìn
phín	ph ín
phinh	ph inh
phình	ph ình
phỉnh	ph ỉnh
phính	ph ính
phít	ph ít
phịt	ph ịt
phiu	ph iu
phìu	ph ìu
phịu	ph ịu
pho	ph o
phò	ph ò
phó	ph ó
phổ	ph ổ
phố	ph ố
phờ	ph ờ
phở	ph ở
phớ	ph ớ
phóc	ph óc
phọc	ph ọc
phốc	ph ốc
phớc	ph ớc
phòi	ph òi
phổi	ph ổi
phối	ph ối
phới	ph ới
phom	ph om
phòm	ph òm
phỏm	ph ỏm
phon	ph on
phón	ph ón
phồn	ph ồn
phờn	ph ờn
phởn	ph ởn
phỡn	ph ỡn
phong	ph ong
phòng	ph òng
phỏng	ph ỏng
phóng	ph óng
phộng	ph ộng
phồng	ph ồng
phổng	ph ổng
phoóc	ph oóc
phóp	ph óp
phốp	ph ốp
phớp	ph ớp
phót	ph ót
phọt	ph ọt
phốt	ph ốt
phớt	ph ớt
phô	ph ô
phôi	ph ôi
phôm	ph ôm
phôn	ph ôn
phông	ph ông
phơ	ph ơ
phơi	ph ơi
phơm	ph ơm
phơn	ph ơn
phu	ph u
phù	ph ù
phủ	ph ủ
phũ	ph ũ
phú	ph ú
phụ	ph ụ
phua	ph ua
phúc	ph úc
phục	ph ục
phức	ph ức
phui	ph ui
phùi	ph ùi
phủi	ph ủi
phum	ph um
phun	ph un
phùn	ph ùn
phừn	ph ừn
phung	ph ung
phùng	ph ùng
phúng	ph úng
phụng	ph ụng
phừng	ph ừng
phuộc	ph uộc
phúp	ph úp
phụp	ph ụp
phút	ph út
phụt	ph ụt
phứt	ph ứt
phựt	ph ựt
phuy	ph uy
phuyn	ph uyn
phưn	ph ưn
phước	ph ước
phưỡn	ph ưỡn
phướn	ph ướn
phường	ph ường
phướng	ph ướng
phượng	ph ượng
phượt	ph ượt
phương	ph ương
pi	p i
pì	p ì
pích	p ích
piềng	p iềng
piêu	p iêu
pin	p in
pín	p ín
pinh	p inh
pỉnh	p ỉnh
píp	p íp
pít	p ít
piu	p iu
po	p o
pồ	p ồ
pờ	p ờ
póc	p óc
poi	p oi
pon	p on
pốp	p ốp
pót	p ót
pốt	p ốt
pô	p ô
pôn	p ôn
pông	p ông
pơ	p ơ
pơn	p ơn
pu	p u
pù	p ù
pù	p ù
pua	p ua
pừn	p ừn
pút	p út
qua	qu a
quà	qu à
quả	qu ả
quá	qu á
quạ	qu ạ
quặc	qu ặc
quắc	qu ắc
quách	qu ách
quạch	qu ạch
quai	qu ai
quái	qu ái
quại	qu ại
quặm	qu ặm
quắm	qu ắm
quan	qu an
quàn	qu àn
quản	qu ản
quán	qu án
quặn	qu ặn
quận	qu ận
quằn	qu ằn
quắn	qu ắn
quần	qu ần
quẩn	qu ẩn
quẫn	qu ẫn
quấn	qu ấn
quang	qu ang
quàng	qu àng
quảng	qu ảng
quãng	qu ãng
quáng	qu áng
quạng	qu ạng
quặng	qu ặng
quẳng	qu ẳng
quầng	qu ầng
quanh	qu anh
quành	qu ành
quánh	qu ánh
quạnh	qu ạnh
quạo	qu ạo
quạp	qu ạp
quặp	qu ặp
quắp	qu ắp
quát	qu át
quạt	qu ạt
quặt	qu ặt
quật	qu ật
quắt	qu ắt
quất	qu ất
quạu	qu ạu
quay	qu ay
quảy	qu ảy
quậy	qu ậy
quầy	qu ầy
quẩy	qu ẩy
quẫy	qu ẫy
quấy	qu ấy
quăn	qu ăn
quăng	qu ăng
quân	qu ân
quây	qu ây
que	qu e
què	qu è
quẻ	qu ẻ
quẽ	qu ẽ
quệ	qu ệ
quế	qu ế
quen	qu en
quèn	qu èn
quện	qu ện
queo	qu eo
quéo	qu éo
quẹo	qu ẹo
quét	qu ét
quẹt	qu ẹt
quệt	qu ệt
quết	qu ết
quê	qu ê
quên	qu ên
qui	qu i
quỉ	qu ỉ
quí	qu í
quin	qu in
quít	qu ít
quịt	qu ịt
quờ	qu ờ
quở	qu ở
quốc	qu ốc
quơ	qu ơ
quy	qu y
quỳ	qu ỳ
quỷ	qu ỷ
quỹ	qu ỹ
quý	qu ý
quỵ	qu ỵ
quyện	qu yện
quyền	qu yền
quyển	qu yển
quyễn	qu yễn
quyến	qu yến
quyệt	qu yệt
quyết	qu yết
quyên	qu yên
quỳnh	qu ỳnh
quýnh	qu ýnh
quýt	qu ýt
quỵt	qu ỵt
ra	r a
rà	r à
rả	r ả
rã	r ã
rá	r á
rạ	r ạ
rác	r ác
rạc	r ạc
rặc	r ặc
rắc	r ắc
rấc	r ấc
rách	r ách
rạch	r ạch
rai	r ai
rải	r ải
rãi	r ãi
rái	r ái
ram	r am
ràm	r àm
rám	r ám
rạm	r ạm
rậm	r ậm
rằm	r ằm
rắm	r ắm
rầm	r ầm
rấm	r ấm
ran	r an
ràn	r àn
rán	r án
rạn	r ạn
rặn	r ặn
rận	r ận
rằn	r ằn
rắn	r ắn
rần	r ần
rang	r ang
ràng	r àng
rảng	r ảng
rãng	r ãng
ráng	r áng
rạng	r ạng
rặng	r ặng
rằng	r ằng
ranh	r anh
rành	r ành
rảnh	r ảnh
rãnh	r ãnh
rao	r ao
rào	r ào
rảo	r ảo
ráo	r áo
rạo	r ạo
ráp	r áp
rạp	r ạp
rập	r ập
rắp	r ắp
rát	r át
rạt	r ạt
rặt	r ặt
rắt	r ắt
rất	r ất
rau	r au
ráu	r áu
rầu	r ầu
ray	r ay
rày	r ày
rãy	r ãy
ráy	r áy
rầy	r ầy
rẩy	r ẩy
rẫy	r ẫy
răm	r ăm
răn	r ăn
răng	r ăng
râm	r âm
rân	r ân
râu	r âu
rây	r ây
re	r e
rè	r è
rẻ	r ẻ
rẽ	r ẽ
ré	r é
rề	r ề
rể	r ể
rễ	r ễ
rế	r ế
réc	r éc
rẹc	r ẹc
rem	r em
rèm	r èm
ren	r en
rèn	r èn
rẻn	r ẻn
rén	r én
rền	r ền
reng	r eng
rềnh	r ềnh
reo	r eo
rèo	r èo
rẻo	r ẻo
réo	r éo
rép	r ép
rẹp	r ẹp
rệp	r ệp
rếp	r ếp
rét	r ét
rẹt	r ẹt
rệt	r ệt
rết	r ết
rệu	r ệu
rếu	r ếu
rê	r ê
rêm	r êm
rên	r ên
rênh	r ênh
rêu	r êu
ri	r i
rì	r ì
rỉ	r ỉ
rĩ	r ĩ
rí	r í
ria	r ia
rìa	r ìa
rỉa	r ỉa
rịa	r ịa
rích	r ích
rịch	r ịch
riềng	r iềng
riết	r iết
riếu	r iếu
riêng	r iêng
riêu	r iêu
rim	r im
rin	r in
rịn	r ịn
rinh	r inh
rình	r ình
rỉnh	r ỉnh
ríp	r íp
rít	r ít
rịt	r ịt
riu	r iu
rìu	r ìu
ríu	r íu
rịu	r ịu
ro	r o
rò	r ò
rỏ	r ỏ
rõ	r õ
rọ	r ọ
rộ	r ộ
rồ	r ồ
rổ	r ổ
rỗ	r ỗ
rờ	r ờ
rỡ	r ỡ
rớ	r ớ
rợ	r ợ
roa	r oa
ròa	r òa
roam	r oam
roạt	r oạt
róc	r óc
rọc	r ọc
rộc	r ộc
rốc	r ốc
roét	r oét
roẹt	r oẹt
roi	r oi
ròi	r òi
rỏi	r ỏi
rói	r ói
rọi	r ọi
rồi	r ồi
rỗi	r ỗi
rối	r ối
rời	r ời
rợi	r ợi
rom	r om
ròm	r òm
róm	r óm
rộm	r ộm
rởm	r ởm
rớm	r ớm
ron	r on
ròn	r òn
rỏn	r ỏn
rón	r ón
rọn	r ọn
rộn	r ộn
rổn	r ổn
rốn	r ốn
rờn	r ờn
rợn	r ợn
rong	r ong
ròng	r òng
rõng	r õng
rộng	r ộng
rồng	r ồng
rỗng	r ỗng
rống	r ống
roong	r oong
rộp	r ộp
rốp	r ốp
rợp	r ợp
rót	r ót
rọt	r ọt
rột	r ột
rốt	r ốt
rớt	r ớt
rô	r ô
rôm	r ôm
rôn	r ôn
rông	r ông
rơ	r ơ
rơi	r ơi
rơm	r ơm
rơn	r ơn
ru	r u
rù	r ù
rủ	r ủ
rũ	r ũ
rú	r ú
rùa	r ùa
rủa	r ủa
rũa	r ũa
rửa	r ửa
rữa	r ữa
rứa	r ứa
rựa	r ựa
rúc	r úc
rục	r ục
rức	r ức
rực	r ực
rùi	r ùi
rủi	r ủi
rụi	r ụi
rum	r um
rùm	r ùm
rúm	r úm
rụm	r ụm
run	r un
rủn	r ủn
rung	r ung
rùng	r ùng
rủng	r ủng
rúng	r úng
rụng	r ụng
rừng	r ừng
ruốc	r uốc
ruồi	r uồi
ruổi	r uổi
ruộm	r uộm
ruộng	r uộng
ruồng	r uồng
ruỗng	r uỗng
ruột	r uột
rúp	r úp
rụp	r ụp
rút	r út
rụt	r ụt
rứt	r ứt
ruy	r uy
ruýt	r uýt
rưng	r ưng
rước	r ước
rười	r ười
rưởi	r ưởi
rưỡi	r ưỡi
rưới	r ưới
rượi	r ượi
rườm	r ườm
rướm	r ướm
rướn	r ướn
rường	r ường
rượt	r ượt
rượu	r ượu
rươi	r ươi
rương	r ương
sa	s a
sà	s à
sả	s ả
sã	s ã
sá	s á
sạ	s ạ
sác	s ác
sạc	s ạc
sặc	s ặc
sậc	s ậc
sắc	s ắc
sấc	s ấc
sách	s ách
sạch	s ạch
sai	s ai
sài	s ài
sải	s ải
sãi	s ãi
sái	s ái
sại	s ại
sam	s am
sàm	s àm
sảm	s ảm
sám	s ám
sạm	s ạm
sậm	s ậm
sắm	s ắm
sầm	s ầm
sẩm	s ẩm
sẫm	s ẫm
sấm	s ấm
san	s an
sàn	s àn
sản	s ản
sán	s án
sạn	s ạn
sẵn	s ẵn
sắn	s ắn
sần	s ần
sấn	s ấn
sang	s ang
sàng	s àng
sảng	s ảng
sáng	s áng
sằng	s ằng
sẳng	s ẳng
sẵng	s ẵng
sắng	s ắng
sanh	s anh
sành	s ành
sảnh	s ảnh
sánh	s ánh
sao	s ao
sào	s ào
sảo	s ảo
sáo	s áo
sạo	s ạo
sáp	s áp
sạp	s ạp
sặp	s ặp
sập	s ập
sắp	s ắp
sấp	s ấp
sát	s át
sạt	s ạt
sặt	s ặt
sật	s ật
sắt	s ắt
sất	s ất
sau	s au
sáu	s áu
sậu	s ậu
sầu	s ầu
sấu	s ấu
say	s ay
sảy	s ảy
sậy	s ậy
sẩy	s ẩy
sấy	s ấy
săm	s ăm
săn	s ăn
săng	s ăng
sâm	s âm
sân	s ân
sâng	s âng
sâu	s âu
sây	s ây
se	s e
sẻ	s ẻ
sẽ	s ẽ
sệ	s ệ
sề	s ề
sể	s ể
séc	s éc
sẹc	s ẹc
sếch	s ếch
sém	s ém
sen	s en
sèn	s èn
sẻn	s ẻn
sền	s ền
sển	s ển
sến	s ến
seng	s eng
sèng	s èng
seo	s eo
sèo	s èo
sẹo	s ẹo
sép	s ép
sẹp	s ẹp
sệp	s ệp
sếp	s ếp
sét	s ét
sệt	s ệt
sết	s ết
sếu	s ếu
sê	s ê
sêm	s êm
sên	s ên
sênh	s ênh
sêu	s êu
si	s i
sì	s ì
sỉ	s ỉ
sĩ	s ĩ
sí	s í
sích	s ích
sịch	s ịch
siết	s iết
siêm	s iêm
siêng	s iêng
siêu	s iêu
sim	s im
sin	s in
sìn	s ìn
sỉn	s ỉn
sín	s ín
sịn	s ịn
sinh	s inh
sình	s ình
sính	s ính
síp	s íp
sịp	s ịp
sít	s ít
sịt	s ịt
siu	s iu
so	s o
sò	s ò
sỏ	s ỏ
só	s ó
sọ	s ọ
sộ	s ộ
sồ	s ồ
sổ	s ổ
sỗ	s ỗ
số	s ố
sờ	s ờ
sở	s ở
sỡ	s ỡ
sớ	s ớ
sợ	s ợ
soa	s oa
soài	s oài
soải	s oải
soái	s oái
soàn	s oàn
soán	s oán
soạn	s oạn
soạng	s oạng
soáp	s oáp
soắp	s oắp
soát	s oát
soạt	s oạt
sóc	s óc
sọc	s ọc
sộc	s ộc
sốc	s ốc
soen	s oen
soẹt	s oẹt
soi	s oi
sòi	s òi
sỏi	s ỏi
sõi	s õi
sói	s ói
sọi	s ọi
sồi	s ồi
sởi	s ởi
sới	s ới
sợi	s ợi
som	s om
sòm	s òm
sồm	s ồm
sớm	s ớm
son	s on
sỏn	s ỏn
són	s ón
sồn	s ồn
sờn	s ờn
sởn	s ởn
sớn	s ớn
song	s ong
sòng	s òng
sỏng	s ỏng
sõng	s õng
sóng	s óng
sồng	s ồng
sổng	s ổng
sống	s ống
soóc	s oóc
soọc	s oọc
sóp	s óp
sọp	s ọp
sộp	s ộp
sốp	s ốp
sớp	s ớp
sót	s ót
sọt	s ọt
sột	s ột
sốt	s ốt
sớt	s ớt
sô	s ô
sôi	s ôi
sôm	s ôm
sôn	s ôn
sông	s ông
sơ	s ơ
sơi	s ơi
sơm	s ơm
sơn	s ơn
su	s u
sù	s ù
sủ	s ủ
sú	s ú
sụ	s ụ
sừ	s ừ
sử	s ử
sứ	s ứ
sự	s ự
sủa	s ủa
súa	s úa
sụa	s ụa
sửa	s ửa
sữa	s ữa
sứa	s ứa
suất	s uất
súc	s úc
sục	s ục
sức	s ức
sực	s ực
suề	s uề
suê	s uê
suêm	s uêm
suên	s uên
sui	s ui
sùi	s ùi
sủi	s ủi
sùm	s ùm
sun	s un
sủn	s ủn
sún	s ún
sụn	s ụn
sừn	s ừn
sung	s ung
sùng	s ùng
sủng	s ủng
sũng	s ũng
súng	s úng
sừng	s ừng
sửng	s ửng
sững	s ững
suối	s uối
suồng	s uồng
suốt	s uốt
suôn	s uôn
suông	s uông
súp	s úp
sụp	s ụp
sút	s út
sụt	s ụt
sứt	s ứt
sựt	s ựt
sửu	s ửu
suy	s uy
sùy	s ùy
súy	s úy
suyễn	s uyễn
suýt	s uýt
suỵt	s uỵt
sư	s ư
sưa	s ưa
sưi	s ưi
sưn	s ưn
sưng	s ưng
sưởi	s ưởi
sườn	s ườn
sường	s ường
sướng	s ướng
sượng	s ượng
sướt	s ướt
sượt	s ượt
sương	s ương
sưu	s ưu
sỹ	s ỹ
ta	t a
tà	t à
tả	t ả
tã	t ã
tá	t á
tạ	t ạ
tác	t ác
tạc	t ạc
tặc	t ặc
tắc	t ắc
tấc	t ấc
tách	t ách
tạch	t ạch
tai	t ai
tài	t ài
tải	t ải
tái	t ái
tại	t ại
tam	t am
tàm	t àm
tám	t ám
tạm	t ạm
tậm	t ậm
tằm	t ằm
tắm	t ắm
tầm	t ầm
tẩm	t ẩm
tấm	t ấm
tan	t an
tàn	t àn
tản	t ản
tán	t án
tạn	t ạn
tận	t ận
tằn	t ằn
tắn	t ắn
tần	t ần
tẩn	t ẩn
tấn	t ấn
tang	t ang
tàng	t àng
tảng	t ảng
táng	t áng
tạng	t ạng
tặng	t ặng
tằng	t ằng
tầng	t ầng
tanh	t anh
tành	t ành
tánh	t ánh
tạnh	t ạnh
tao	t ao
tào	t ào
tảo	t ảo
táo	t áo
tạo	t ạo
táp	t áp
tạp	t ạp
tập	t ập
tắp	t ắp
tấp	t ấp
tát	t át
tạt	t ạt
tật	t ật
tắt	t ắt
tất	t ất
tau	t au
tàu	t àu
táu	t áu
tậu	t ậu
tầu	t ầu
tẩu	t ẩu
tấu	t ấu
tay	t ay
tày	t ày
táy	t áy
tẩy	t ẩy
tấy	t ấy
tăm	t ăm
tăn	t ăn
tăng	t ăng
tâm	t âm
tân	t ân
tâng	t âng
tâu	t âu
tây	t ây
te	t e
tè	t è
tẻ	t ẻ
té	t é
tệ	t ệ
tề	t ề
tể	t ể
tễ	t ễ
tế	t ế
téc	t éc
tệch	t ệch
tếch	t ếch
tem	t em
tém	t ém
ten	t en
tèn	t èn
tẽn	t ẽn
tén	t én
teng	t eng
tèng	t èng
tễnh	t ễnh
teo	t eo
tèo	t èo
tẻo	t ẻo
tẹo	t ẹo
tép	t ép
tẹp	t ẹp
tệp	t ệp
tếp	t ếp
tét	t ét
tẹt	t ẹt
tết	t ết
tễu	t ễu
tếu	t ếu
tê	t ê
têm	t êm
tên	t ên
tênh	t ênh
têu	t êu
tha	th a
thà	th à
thả	th ả
thá	th á
thác	th ác
thạc	th ạc
thắc	th ắc
thách	th ách
thạch	th ạch
thai	th ai
thài	th ài
thải	th ải
thãi	th ãi
thái	th ái
tham	th am
thảm	th ảm
thám	th ám
thậm	th ậm
thẳm	th ẳm
thắm	th ắm
thầm	th ầm
thẩm	th ẩm
thẫm	th ẫm
thấm	th ấm
than	th an
thàn	th àn
thản	th ản
thán	th án
thận	th ận
thằn	th ằn
thắn	th ắn
thần	th ần
thẩn	th ẩn
thẫn	th ẫn
thang	th ang
thàng	th àng
thảng	th ảng
tháng	th áng
thặng	th ặng
thằng	th ằng
thẳng	th ẳng
thắng	th ắng
thanh	th anh
thành	th ành
thảnh	th ảnh
thánh	th ánh
thạnh	th ạnh
thao	th ao
thào	th ào
thảo	th ảo
tháo	th áo
thạo	th ạo
tháp	th áp
thạp	th ạp
thập	th ập
thắp	th ắp
thấp	th ấp
thát	th át
thạt	th ạt
thật	th ật
thắt	th ắt
thất	th ất
thau	th au
thầu	th ầu
thấu	th ấu
thay	th ay
thày	th ày
thảy	th ảy
thầy	th ầy
thấy	th ấy
thăm	th ăm
thăn	th ăn
thăng	th ăng
thâm	th âm
thân	th ân
thâu	th âu
thây	th ây
the	th e
thè	th è
thẻ	th ẻ
thé	th é
thệ	th ệ
thề	th ề
thể	th ể
thế	th ế
thếch	th ếch
them	th em
thèm	th èm
thềm	th ềm
then	th en
thèn	th èn
thẻn	th ẻn
thẹn	th ẹn
theo	th eo
thẹo	th ẹo
thép	th ép
thếp	th ếp
thét	th ét
thết	th ết
thệu	th ệu
thều	th ều
thểu	th ểu
thê	th ê
thêm	th êm
thên	th ên
thênh	th ênh
thêu	th êu
thi	th i
thì	th ì
thỉ	th ỉ
thí	th í
thị	th ị
thia	th ia
thìa	th ìa
thía	th ía
thích	th ích
thịch	th ịch
thiệc	th iệc
thiếc	th iếc
thiềm	th iềm
thiểm	th iểm
thiện	th iện
thiền	th iền
thiển	th iển
thiến	th iến
thiệp	th iệp
thiếp	th iếp
thiệt	th iệt
thiết	th iết
thiệu	th iệu
thiều	th iều
thiểu	th iểu
thiếu	th iếu
thiêm	th iêm
thiên	th iên
thiêng	th iêng
thiêu	th iêu
thim	th im
thím	th ím
thin	th in
thìn	th ìn
thín	th ín
thinh	th inh
thình	th ình
thỉnh	th ỉnh
thính	th ính
thịnh	th ịnh
thíp	th íp
thít	th ít
thịt	th ịt
thiu	th iu
thỉu	th ỉu
tho	th o
thò	th ò
thỏ	th ỏ
thó	th ó
thọ	th ọ
thồ	th ồ
thổ	th ổ
thố	th ố
thờ	th ờ
thở	th ở
thớ	th ớ
thợ	th ợ
thoa	th oa
thỏa	th ỏa
thóa	th óa
thoai	th oai
thoải	th oải
thoái	th oái
thoại	th oại
thoan	th oan
thoang	th oang
thoàng	th oàng
thoảng	th oảng
thoáng	th oáng
thoắng	th oắng
thoát	th oát
thoạt	th oạt
thoắt	th oắt
thoăn	th oăn
thóc	th óc
thọc	th ọc
thốc	th ốc
thoen	th oen
thoi	th oi
thòi	th òi
thỏi	th ỏi
thói	th ói
thồi	th ồi
thổi	th ổi
thối	th ối
thời	th ời
thới	th ới
thòm	th òm
thỏm	th ỏm
thon	th on
thòn	th òn
thồn	th ồn
thổn	th ổn
thốn	th ốn
thong	th ong
thòng	th òng
thõng	th õng
thọng	th ọng
thồng	th ồng
thống	th ống
thoóc	th oóc
thoọc	th oọc
thóp	th óp
thót	th ót
thọt	th ọt
thốt	th ốt
thớt	th ớt
thô	th ô
thôi	th ôi
thôn	th ôn
thông	th ông
thơ	th ơ
thơi	th ơi
thơm	th ơm
thơn	th ơn
thu	th u
thù	th ù
thủ	th ủ
thú	th ú
thụ	th ụ
thừ	th ừ
thử	th ử
thứ	th ứ
thự	th ự
thua	th ua
thùa	th ùa
thủa	th ủa
thừa	th ừa
thửa	th ửa
thứa	th ứa
thuận	th uận
thuần	th uần
thuẩn	th uẩn
thuẫn	th uẫn
thuấn	th uấn
thuật	th uật
thuân	th uân
thúc	th úc
thục	th ục
thức	th ức
thực	th ực
thuệ	th uệ
thuế	th uế
thuê	th uê
thuên	th uên
thui	th ui
thùi	th ùi
thủi	th ủi
thúi	th úi
thụi	th ụi
thum	th um
thủm	th ủm
thun	th un
thừn	th ừn
thung	th ung
thùng	th ùng
thủng	th ủng
thũng	th ũng
thúng	th úng
thừng	th ừng
thững	th ững
thuở	th uở
thuộc	th uộc
thuốc	th uốc
thuộm	th uộm
thuồng	th uồng
thuổng	th uổng
thuột	th uột
thuôn	th uôn
thụp	th ụp
thút	th út
thụt	th ụt
thuỳ	th uỳ
thùy	th ùy
thủy	th ủy
thúy	th úy
thụy	th ụy
thuyền	th uyền
thuyết	th uyết
thuyên	th uyên
thuyn	th uyn
thư	th ư
thưa	th ưa
thưn	th ưn
thưng	th ưng
thước	th ước
thược	th ược
thườn	th ườn
thưỡn	th ưỡn
thường	th ường
thưởng	th ưởng
thượng	th ượng
thướt	th ướt
thượt	th ượt
thương	th ương
thy	th y
ti	t i
tì	t ì
tỉ	t ỉ
tí	t í
tị	t ị
tia	t ia
tỉa	t ỉa
tía	t ía
tíc	t íc
tích	t ích
tịch	t ịch
tiệc	t iệc
tiếc	t iếc
tiệm	t iệm
tiềm	t iềm
tiếm	t iếm
tiện	t iện
tiền	t iền
tiển	t iển
tiễn	t iễn
tiến	t iến
tiếng	t iếng
tiệp	t iệp
tiếp	t iếp
tiệt	t iệt
tiết	t iết
tiều	t iều
tiểu	t iểu
tiễu	t iễu
tiếu	t iếu
tiêm	t iêm
tiên	t iên
tiêng	t iêng
tiêu	t iêu
tim	t im
tìm	t ìm
tỉm	t ỉm
tím	t ím
tin	t in
tỉn	t ỉn
tĩn	t ĩn
tín	t ín
tinh	t inh
tình	t ình
tỉnh	t ỉnh
tĩnh	t ĩnh
tính	t ính
tịnh	t ịnh
típ	t íp
tít	t ít
tịt	t ịt
tiu	t iu
tìu	t ìu
tỉu	t ỉu
tĩu	t ĩu
tíu	t íu
tịu	t ịu
to	t o
tò	t ò
tỏ	t ỏ
tó	t ó
tộ	t ộ
tồ	t ồ
tổ	t ổ
tố	t ố
tờ	t ờ
tở	t ở
tớ	t ớ
toa	t oa
tòa	t òa
tỏa	t ỏa
tọa	t ọa
toác	t oác
toạc	t oạc
toạch	t oạch
toài	t oài
toái	t oái
toại	t oại
toan	t oan
toàn	t oàn
toản	t oản
toán	t oán
toang	t oang
toàng	t oàng
toáng	t oáng
toanh	t oanh
toát	t oát
tóc	t óc
tọc	t ọc
tộc	t ộc
tốc	t ốc
tớc	t ớc
toe	t oe
tòe	t òe
tõe	t õe
tóe	t óe
tọe	t ọe
toen	t oen
toét	t oét
toẹt	t oẹt
toi	t oi
tòi	t òi
tỏi	t ỏi
tói	t ói
tội	t ội
tồi	t ồi
tối	t ối
tời	t ời
tới	t ới
tom	t om
tòm	t òm
tõm	t õm
tóm	t óm
tởm	t ởm
ton	t on
tòn	t òn
tỏn	t ỏn
tồn	t ồn
tổn	t ổn
tốn	t ốn
tởn	t ởn
tợn	t ợn
tong	t ong
tòng	t òng
tỏng	t ỏng
tồng	t ồng
tổng	t ổng
tống	t ống
tóp	t óp
tọp	t ọp
tộp	t ộp
tốp	t ốp
tớp	t ớp
tợp	t ợp
tót	t ót
tọt	t ọt
tột	t ột
tốt	t ốt
tớt	t ớt
tô	t ô
tôi	t ôi
tôm	t ôm
tôn	t ôn
tông	t ông
tơ	t ơ
tơi	t ơi
tơm	t ơm
tơn	t ơn
tra	tr a
trà	tr à
trả	tr ả
trá	tr á
trác	tr ác
trạc	tr ạc
trặc	tr ặc
trắc	tr ắc
trách	tr ách
trạch	tr ạch
trai	tr ai
trải	tr ải
trãi	tr ãi
trái	tr ái
trại	tr ại
tràm	tr àm
trảm	tr ảm
trám	tr ám
trạm	tr ạm
trắm	tr ắm
trầm	tr ầm
trẫm	tr ẫm
tràn	tr àn
trán	tr án
trận	tr ận
trằn	tr ằn
trần	tr ần
trấn	tr ấn
trang	tr ang
tràng	tr àng
trảng	tr ảng
tráng	tr áng
trạng	tr ạng
trắng	tr ắng
tranh	tr anh
trành	tr ành
tránh	tr ánh
trao	tr ao
trào	tr ào
trảo	tr ảo
tráo	tr áo
trạo	tr ạo
tráp	tr áp
trập	tr ập
trát	tr át
trật	tr ật
trau	tr au
tràu	tr àu
trầu	tr ầu
trấu	tr ấu
trảy	tr ảy
trầy	tr ầy
trẩy	tr ẩy
trăm	tr ăm
trăn	tr ăn
trăng	tr ăng
trâm	tr âm
trân	tr ân
trâu	tr âu
trây	tr ây
tre	tr e
trẻ	tr ẻ
trẽ	tr ẽ
tré	tr é
trệ	tr ệ
trề	tr ề
trễ	tr ễ
trệch	tr ệch
trèm	tr èm
trẽn	tr ẽn
treo	tr eo
trèo	tr èo
trẻo	tr ẻo
tréo	tr éo
trẹo	tr ẹo
trét	tr ét
trệt	tr ệt
trê	tr ê
trên	tr ên
trêu	tr êu
tri	tr i
trì	tr ì
trĩ	tr ĩ
trí	tr í
trị	tr ị
trỉa	tr ỉa
trịa	tr ịa
trích	tr ích
trịch	tr ịch
triện	tr iện
triền	tr iền
triển	tr iển
triệt	tr iệt
triết	tr iết
triệu	tr iệu
triều	tr iều
triêm	tr iêm
trim	tr im
trinh	tr inh
trình	tr ình
trĩnh	tr ĩnh
trịnh	tr ịnh
trìu	tr ìu
trĩu	tr ĩu
tro	tr o
trò	tr ò
trỏ	tr ỏ
trọ	tr ọ
trộ	tr ộ
trồ	tr ồ
trổ	tr ổ
trỗ	tr ỗ
trố	tr ố
trờ	tr ờ
trở	tr ở
trớ	tr ớ
trợ	tr ợ
tróc	tr óc
trọc	tr ọc
trốc	tr ốc
tròi	tr òi
trói	tr ói
trọi	tr ọi
trội	tr ội
trồi	tr ồi
trỗi	tr ỗi
trối	tr ối
trời	tr ời
tròm	tr òm
trộm	tr ộm
tròn	tr òn
trọn	tr ọn
trộn	tr ộn
trốn	tr ốn
trớn	tr ớn
trợn	tr ợn
trong	tr ong
tròng	tr òng
trỏng	tr ỏng
trọng	tr ọng
trồng	tr ồng
trống	tr ống
tróp	tr óp
trót	tr ót
trọt	tr ọt
trợt	tr ợt
trôi	tr ôi
trôm	tr ôm
trôn	tr ôn
trông	tr ông
trơ	tr ơ
trơi	tr ơi
trơn	tr ơn
tru	tr u
trù	tr ù
trú	tr ú
trụ	tr ụ
trừ	tr ừ
trữ	tr ữ
trứ	tr ứ
truật	tr uật
truất	tr uất
truân	tr uân
trúc	tr úc
trục	tr ục
trực	tr ực
trũi	tr ũi
trụi	tr ụi
trum	tr um
trùm	tr ùm
trúm	tr úm
trùn	tr ùn
trung	tr ung
trùng	tr ùng
trũng	tr ũng
trúng	tr úng
trụng	tr ụng
trừng	tr ừng
trửng	tr ửng
trứng	tr ứng
truồi	tr uồi
truồng	tr uồng
truông	tr uông
trút	tr út
trừu	tr ừu
truy	tr uy
trụy	tr ụy
truyện	tr uyện
truyền	tr uyền
truyển	tr uyển
trư	tr ư
trưa	tr ưa
trưng	tr ưng
trước	tr ước
trược	tr ược
trườn	tr ườn
trường	tr ường
trưởng	tr ưởng
trướng	tr ướng
trượng	tr ượng
trượt	tr ượt
trươi	tr ươi
trương	tr ương
tu	t u
tù	t ù
tủ	t ủ
tú	t ú
tụ	t ụ
từ	t ừ
tử	t ử
tứ	t ứ
tự	t ự
tua	t ua
tùa	t ùa
tủa	t ủa
túa	t úa
từa	t ừa
tứa	t ứa
tựa	t ựa
tuần	t uần
tuẫn	t uẫn
tuấn	t uấn
tuất	t uất
tuân	t uân
túc	t úc
tục	t ục
tức	t ức
tực	t ực
tuệ	t uệ
tuế	t uế
tuếch	t uếch
tuềnh	t uềnh
tuên	t uên
tui	t ui
tủi	t ủi
túi	t úi
tụi	t ụi
tum	t um
tùm	t ùm
tủm	t ủm
túm	t úm
tụm	t ụm
từm	t ừm
tun	t un
tủn	t ủn
tũn	t ũn
tún	t ún
từn	t ừn
tửn	t ửn
tung	t ung
tùng	t ùng
túng	t úng
tụng	t ụng
từng	t ừng
tửng	t ửng
tuộc	t uộc
tuốc	t uốc
tuồi	t uồi
tuổi	t uổi
tuồn	t uồn
tuồng	t uồng
tuột	t uột
tuốt	t uốt
tuôn	t uôn
tuông	t uông
túp	t úp
tút	t út
tụt	t ụt
tửu	t ửu
tựu	t ựu
tuy	t uy
tuỳ	t uỳ
tùy	t ùy
tủy	t ủy
túy	t úy
tụy	t ụy
tuya	t uya
tuyền	t uyền
tuyển	t uyển
tuyến	t uyến
tuyệt	t uyệt
tuyết	t uyết
tuyên	t uyên
tuyn	t uyn
tuýp	t uýp
tuýt	t uýt
tư	t ư
tưa	t ưa
tưm	t ưm
tưn	t ưn
tưng	t ưng
tước	t ước
tược	t ược
tưởi	t ưởi
tưới	t ưới
tường	t ường
tưởng	t ưởng
tướng	t ướng
tượng	t ượng
tươi	t ươi
tươm	t ươm
tương	t ương
ty	t y
tỳ	t ỳ
tỷ	t ỷ
tý	t ý
tỵ	t ỵ
u	u
ù	ù
ủ	ủ
ú	ú
ụ	ụ
ừ	ừ
ử	ử
ứ	ứ
ự	ự
ùa	ùa
ủa	ủa
úa	úa
ừa	ừa
ứa	ứa
uẩn	uẩn
uất	uất
úc	úc
ục	ục
ức	ức
ực	ực
uể	uể
uế	uế
uê	uê
ui	ui
ùi	ùi
ủi	ủi
úi	úi
um	um
ùm	ùm
úm	úm
ừm	ừm
un	un
ùn	ùn
ủn	ủn
ừn	ừn
ung	ung
ùng	ùng
ủng	ủng
úng	úng
ừng	ừng
ửng	ửng
ứng	ứng
uồi	uồi
uốn	uốn
uổng	uổng
uống	uống
uột	uột
uôi	uôi
uôn	uôn
uông	uông
úp	úp
ụp	ụp
út	út
ụt	ụt
uy	uy
ủy	ủy
úy	úy
uỵch	uỵch
uyển	uyển
uyên	uyên
uỳnh	uỳnh
uýnh	uýnh
uýt	uýt
ư	ư
ưa	ưa
ưi	ưi
ưm	ưm
ưn	ưn
ưng	ưng
ước	ước
ướm	ướm
ườn	ườn
ưỡn	ưỡn
ướp	ướp
ướt	ướt
ươi	ươi
ươm	ươm
ươn	ươn
ương	ương
ưu	ưu
va	v a
và	v à
vả	v ả
vã	v ã
vá	v á
vạ	v ạ
vác	v ác
vạc	v ạc
vặc	v ặc
vắc	v ắc
vách	v ách
vạch	v ạch
vai	v ai
vài	v ài
vải	v ải
vãi	v ãi
vái	v ái
vại	v ại
vàm	v àm
vạm	v ạm
vầm	v ầm
van	v an
vàn	v àn
vãn	v ãn
ván	v án
vạn	v ạn
vặn	v ặn
vận	v ận
vằn	v ằn
vắn	v ắn
vần	v ần
vẩn	v ẩn
vẫn	v ẫn
vấn	v ấn
vang	v ang
vàng	v àng
vảng	v ảng
vãng	v ãng
váng	v áng
vạng	v ạng
vằng	v ằng
vẳng	v ẳng
vắng	v ắng
vầng	v ầng
vanh	v anh
vành	v ành
vãnh	v ãnh
vánh	v ánh
vạnh	v ạnh
vào	v ào
váo	v áo
váp	v áp
vập	v ập
vấp	v ấp
vát	v át
vạt	v ạt
vặt	v ặt
vật	v ật
vắt	v ắt
vất	v ất
vầu	v ầu
vẩu	v ẩu
vay	v ay
vày	v ày
vảy	v ảy
váy	v áy
vạy	v ạy
vậy	v ậy
vầy	v ầy
vẩy	v ẩy
vẫy	v ẫy
vấy	v ấy
văn	v ăn
văng	v ăng
vân	v ân
vâng	v âng
vâu	v âu
vây	v ây
ve	v e
vè	v è
vẻ	v ẻ
vẽ	v ẽ
vé	v é
vệ	v ệ
về	v ề
vế	v ế
véc	v éc
vếch	v ếch
vẹm	v ẹm
ven	v en
vẻn	v ẻn
vén	v én
vẹn	v ẹn
vểnh	v ểnh
veo	v eo
vèo	v èo
vẻo	v ẻo
véo	v éo
vẹo	v ẹo
vếp	v ếp
vét	v ét
vẹt	v ẹt
vệt	v ệt
vết	v ết
vếu	v ếu
vê	v ê
vên	v ên
vênh	v ênh
vêu	v êu
vi	v i
vì	v ì
vỉ	v ỉ
vĩ	v ĩ
ví	v í
vị	v ị
via	v ia
vìa	v ìa
vỉa	v ỉa
vía	v ía
vích	v ích
việc	v iệc
viếc	v iếc
viện	v iện
viền	v iền
viển	v iển
viễn	v iễn
viềng	v iềng
viếng	v iếng
việt	v iệt
viết	v iết
viêm	v iêm
viên	v iên
viêng	v iêng
vim	v im
vin	v in
vìn	v ìn
vịn	v ịn
vinh	v inh
vĩnh	v ĩnh
vịnh	v ịnh
víp	v íp
vít	v ít
vịt	v ịt
viu	v iu
víu	v íu
vo	v o
vò	v ò
vỏ	v ỏ
võ	v õ
vó	v ó
vọ	v ọ
vồ	v ồ
vổ	v ổ
vỗ	v ỗ
vố	v ố
vờ	v ờ
vở	v ở
vỡ	v ỡ
vớ	v ớ
vợ	v ợ
voa	v oa
voan	v oan
voăn	v oăn
voăng	v oăng
vóc	v óc
vọc	v ọc
vốc	v ốc
voi	v oi
vòi	v òi
vói	v ói
vội	v ội
vối	v ối
vời	v ời
với	v ới
vợi	v ợi
vòm	v òm
von	v on
vỏn	v ỏn
vón	v ón
vồn	v ồn
vốn	v ốn
vờn	v ờn
vởn	v ởn
vong	v ong
vòng	v òng
võng	v õng
vọng	v ọng
vồng	v ồng
vống	v ống
vờng	v ờng
voóc	v oóc
voọc	v oọc
vọp	v ọp
vót	v ót
vọt	v ọt
vốt	v ốt
vớt	v ớt
vợt	v ợt
vô	v ô
vôi	v ôi
vôn	v ôn
vông	v ông
vơ	v ơ
vơi	v ơi
vu	v u
vù	v ù
vũ	v ũ
vú	v ú
vụ	v ụ
vừ	v ừ
vua	v ua
vừa	v ừa
vửa	v ửa
vữa	v ữa
vựa	v ựa
vục	v ục
vức	v ức
vực	v ực
vuên	v uên
vui	v ui
vùi	v ùi
vun	v un
vùn	v ùn
vụn	v ụn
vung	v ung
vùng	v ùng
vũng	v ũng
vụng	v ụng
vừng	v ừng
vững	v ững
vựng	v ựng
vuột	v uột
vuốt	v uốt
vuông	v uông
vút	v út
vụt	v ụt
vứt	v ứt
vuy	v uy
vưi	v ưi
vưn	v ưn
vược	v ược
vưởi	v ưởi
vườn	v ườn
vượn	v ượn
vưởng	v ưởng
vướng	v ướng
vượng	v ượng
vượt	v ượt
vươn	v ươn
vương	v ương
vy	v y
vỹ	v ỹ
xa	x a
xà	x à
xả	x ả
xã	x ã
xá	x á
xạ	x ạ
xác	x ác
xạc	x ạc
xậc	x ậc
xắc	x ắc
xấc	x ấc
xách	x ách
xạch	x ạch
xài	x ài
xãi	x ãi
xái	x ái
xàm	x àm
xám	x ám
xạm	x ạm
xầm	x ầm
xẩm	x ẩm
xan	x an
xán	x án
xận	x ận
xắn	x ắn
xần	x ần
xang	x ang
xáng	x áng
xạng	x ạng
xằng	x ằng
xẳng	x ẳng
xanh	x anh
xành	x ành
xảnh	x ảnh
xao	x ao
xào	x ào
xảo	x ảo
xáo	x áo
xạo	x ạo
xập	x ập
xắp	x ắp
xấp	x ấp
xát	x át
xạt	x ạt
xắt	x ắt
xất	x ất
xẩu	x ẩu
xấu	x ấu
xay	x ay
xảy	x ảy
xẩy	x ẩy
xăm	x ăm
xăn	x ăn
xăng	x ăng
xâm	x âm
xân	x ân
xâng	x âng
xâu	x âu
xây	x ây
xe	x e
xè	x è
xẻ	x ẻ
xé	x é
xệ	x ệ
xề	x ề
xế	x ế
xéc	x éc
xệch	x ệch
xếch	x ếch
xem	x em
xém	x ém
xen	x en
xèn	x èn
xén	x én
xèng	x èng
xẻng	x ẻng
xềnh	x ềnh
xểnh	x ểnh
xeo	x eo
xèo	x èo
xẻo	x ẻo
xéo	x éo
xẹo	x ẹo
xép	x ép
xẹp	x ẹp
xệp	x ệp
xếp	x ếp
xét	x ét
xẹt	x ẹt
xệt	x ệt
xết	x ết
xê	x ê
xêm	x êm
xên	x ên
xênh	x ênh
xi	x i
xì	x ì
xỉ	x ỉ
xí	x í
xị	x ị
xia	x ia
xìa	x ìa
xỉa	x ỉa
xía	x ía
xịa	x ịa
xích	x ích
xịch	x ịch
xiếc	x iếc
xiền	x iền
xiển	x iển
xiệng	x iệng
xiềng	x iềng
xiểng	x iểng
xiết	x iết
xiêm	x iêm
xiên	x iên
xiêng	x iêng
xiêu	x iêu
xim	x im
xím	x ím
xin	x in
xìn	x ìn
xỉn	x ỉn
xín	x ín
xịn	x ịn
xinh	x inh
xình	x ình
xỉnh	x ỉnh
xĩnh	x ĩnh
xính	x ính
xíp	x íp
xịp	x ịp
xít	x ít
xịt	x ịt
xiu	x iu
xìu	x ìu
xỉu	x ỉu
xíu	x íu
xịu	x ịu
xo	x o
xò	x ò
xỏ	x ỏ
xó	x ó
xộ	x ộ
xồ	x ồ
xổ	x ổ
xờ	x ờ
xở	x ở
xớ	x ớ
xoa	x oa
xòa	x òa
xõa	x õa
xóa	x óa
xoạc	x oạc
xoạch	x oạch
xoài	x oài
xoan	x oan
xoàn	x oàn
xoắn	x oắn
xoang	x oang
xoàng	x oàng
xoảng	x oảng
xoành	x oành
xoạt	x oạt
xoay	x oay
xoáy	x oáy
xoăn	x oăn
xóc	x óc
xọc	x ọc
xộc	x ộc
xốc	x ốc
xoe	x oe
xòe	x òe
xoen	x oen
xoét	x oét
xoẹt	x oẹt
xói	x ói
xổi	x ổi
xối	x ối
xời	x ời
xởi	x ởi
xới	x ới
xóm	x óm
xồm	x ồm
xổm	x ổm
xờm	x ờm
xon	x on
xòn	x òn
xỏn	x ỏn
xộn	x ộn
xồn	x ồn
xốn	x ốn
xớn	x ớn
xong	x ong
xòng	x òng
xỏng	x ỏng
xõng	x õng
xồng	x ồng
xổng	x ổng
xoong	x oong
xọp	x ọp
xốp	x ốp
xót	x ót
xốt	x ốt
xô	x ô
xôi	x ôi
xôm	x ôm
xôn	x ôn
xông	x ông
xơ	x ơ
xơi	x ơi
xơn	x ơn
xu	x u
xù	x ù
xú	x ú
xử	x ử
xứ	x ứ
xua	x ua
xùa	x ùa
xửa	x ửa
xuẩn	x uẩn
xuất	x uất
xuân	x uân
xúc	x úc
xức	x ức
xực	x ực
xuề	x uề
xuể	x uể
xuê	x uê
xui	x ui
xúi	x úi
xum	x um
xùm	x ùm
xúm	x úm
xừm	x ừm
xừn	x ừn
xung	x ung
xúng	x úng
xửng	x ửng
xứng	x ứng
xuồng	x uồng
xuống	x uống
xuôi	x uôi
xuông	x uông
xúp	x úp
xụp	x ụp
xút	x út
xứt	x ứt
xựt	x ựt
xuy	x uy
xùy	x ùy
xúy	x úy
xuyền	x uyền
xuyến	x uyến
xuyệt	x uyệt
xuyết	x uyết
xuyên	x uyên
xuyn	x uyn
xuýt	x uýt
xư	x ư
xưa	x ưa
xưi	x ưi
xưm	x ưm
xưn	x ưn
xưng	x ưng
xước	x ước
xược	x ược
xường	x ường
xưởng	x ưởng
xướng	x ướng
xượng	x ượng
xướp	x ướp
xương	x ương
xy	x y
y	y
ỳ	ỳ
ỷ	ỷ
ỹ	ỹ
ý	ý
yểm	yểm
yếm	yếm
yến	yến
yết	yết
yểu	yểu
yếu	yếu
yêm	yêm
yên	yên
yêng	yêng
yêu	yêu
